STATE/UT,Year,CAUSE,Total Male,Total Female,Total
ANDHRA PRADESH,2001,House Wife,0,2444,2444
ANDHRA PRADESH,2001,Service (Government),135,61,196
ANDHRA PRADESH,2001,Service (Private),674,106,780
ANDHRA PRADESH,2001,Public Sector Undertaking,110,10,120
ANDHRA PRADESH,2001,Student,295,175,470
ANDHRA PRADESH,2001,Unemployed,543,78,621
ANDHRA PRADESH,2001,Self-employed (Business activity),486,82,568
ANDHRA PRADESH,2001,Professional Activity,390,41,431
ANDHRA PRADESH,2001,Farming/Agriculture Activity,1331,178,1509
ANDHRA PRADESH,2001,Others (Please Specify),1029,498,1527
ANDHRA PRADESH,2001,Retired Person,21,5,26
ANDHRA PRADESH,2001,Others (Please Specify),1365,465,1830
ANDHRA PRADESH,2001,Total,6379,4143,10522
ANDHRA PRADESH,2001,Total Salaried,919,177,1096
ANDHRA PRADESH,2001,Total Self-employed,3236,799,4035
ANDHRA PRADESH,2002,House Wife,0,2192,2192
ANDHRA PRADESH,2002,Service (Government),100,21,121
ANDHRA PRADESH,2002,Service (Private),629,87,716
ANDHRA PRADESH,2002,Public Sector Undertaking,127,34,161
ANDHRA PRADESH,2002,Student,303,208,511
ANDHRA PRADESH,2002,Unemployed,674,169,843
ANDHRA PRADESH,2002,Self-employed (Business activity),708,89,797
ANDHRA PRADESH,2002,Professional Activity,372,54,426
ANDHRA PRADESH,2002,Farming/Agriculture Activity,1629,267,1896
ANDHRA PRADESH,2002,Others (Please Specify),1144,352,1496
ANDHRA PRADESH,2002,Retired Person,36,0,36
ANDHRA PRADESH,2002,Others (Please Specify),1849,649,2498
ANDHRA PRADESH,2002,Total,7571,4122,11693
ANDHRA PRADESH,2002,Total Salaried,856,142,998
ANDHRA PRADESH,2002,Total Self-employed,3853,762,4615
ANDHRA PRADESH,2003,House Wife,0,1929,1929
ANDHRA PRADESH,2003,Service (Government),250,36,286
ANDHRA PRADESH,2003,Service (Private),369,103,472
ANDHRA PRADESH,2003,Public Sector Undertaking,121,55,176
ANDHRA PRADESH,2003,Student,348,221,569
ANDHRA PRADESH,2003,Unemployed,648,78,726
ANDHRA PRADESH,2003,Self-employed (Business activity),596,108,704
ANDHRA PRADESH,2003,Professional Activity,390,27,417
ANDHRA PRADESH,2003,Farming/Agriculture Activity,1442,358,1800
ANDHRA PRADESH,2003,Others (Please Specify),1197,315,1512
ANDHRA PRADESH,2003,Retired Person,77,52,129
ANDHRA PRADESH,2003,Others (Please Specify),2075,614,2689
ANDHRA PRADESH,2003,Total,7513,3896,11409
ANDHRA PRADESH,2003,Total Salaried,740,194,934
ANDHRA PRADESH,2003,Total Self-employed,3625,808,4433
ANDHRA PRADESH,2004,House Wife,0,2315,2315
ANDHRA PRADESH,2004,Service (Government),300,14,314
ANDHRA PRADESH,2004,Service (Private),619,80,699
ANDHRA PRADESH,2004,Public Sector Undertaking,63,23,86
ANDHRA PRADESH,2004,Student,315,177,492
ANDHRA PRADESH,2004,Unemployed,562,80,642
ANDHRA PRADESH,2004,Self-employed (Business activity),913,67,980
ANDHRA PRADESH,2004,Professional Activity,329,81,410
ANDHRA PRADESH,2004,Farming/Agriculture Activity,2218,448,2666
ANDHRA PRADESH,2004,Others (Please Specify),1466,367,1833
ANDHRA PRADESH,2004,Retired Person,62,23,85
ANDHRA PRADESH,2004,Others (Please Specify),2235,769,3004
ANDHRA PRADESH,2004,Total,9082,4444,13526
ANDHRA PRADESH,2004,Total Salaried,982,117,1099
ANDHRA PRADESH,2004,Total Self-employed,4926,963,5889
ANDHRA PRADESH,2005,House Wife,0,2179,2179
ANDHRA PRADESH,2005,Service (Government),110,30,140
ANDHRA PRADESH,2005,Service (Private),699,131,830
ANDHRA PRADESH,2005,Public Sector Undertaking,233,44,277
ANDHRA PRADESH,2005,Student,274,226,500
ANDHRA PRADESH,2005,Unemployed,430,80,510
ANDHRA PRADESH,2005,Self-employed (Business activity),882,115,997
ANDHRA PRADESH,2005,Professional Activity,182,38,220
ANDHRA PRADESH,2005,Farming/Agriculture Activity,2017,473,2490
ANDHRA PRADESH,2005,Others (Please Specify),1249,468,1717
ANDHRA PRADESH,2005,Retired Person,57,3,60
ANDHRA PRADESH,2005,Others (Please Specify),2732,790,3522
ANDHRA PRADESH,2005,Total,8865,4577,13442
ANDHRA PRADESH,2005,Total Salaried,1042,205,1247
ANDHRA PRADESH,2005,Total Self-employed,4330,1094,5424
ANDHRA PRADESH,2006,House Wife,0,2156,2156
ANDHRA PRADESH,2006,Service (Government),183,48,231
ANDHRA PRADESH,2006,Service (Private),576,71,647
ANDHRA PRADESH,2006,Public Sector Undertaking,190,14,204
ANDHRA PRADESH,2006,Student,287,225,512
ANDHRA PRADESH,2006,Unemployed,371,58,429
ANDHRA PRADESH,2006,Self-employed (Business activity),842,52,894
ANDHRA PRADESH,2006,Professional Activity,552,22,574
ANDHRA PRADESH,2006,Farming/Agriculture Activity,2000,607,2607
ANDHRA PRADESH,2006,Others (Please Specify),1823,678,2501
ANDHRA PRADESH,2006,Retired Person,51,6,57
ANDHRA PRADESH,2006,Others (Please Specify),1988,476,2464
ANDHRA PRADESH,2006,Total,8863,4413,13276
ANDHRA PRADESH,2006,Total Salaried,949,133,1082
ANDHRA PRADESH,2006,Total Self-employed,5217,1359,6576
ANDHRA PRADESH,2007,House Wife,0,2480,2480
ANDHRA PRADESH,2007,Service (Government),220,55,275
ANDHRA PRADESH,2007,Service (Private),1103,270,1373
ANDHRA PRADESH,2007,Public Sector Undertaking,210,29,239
ANDHRA PRADESH,2007,Student,420,279,699
ANDHRA PRADESH,2007,Unemployed,340,63,403
ANDHRA PRADESH,2007,Self-employed (Business activity),925,55,980
ANDHRA PRADESH,2007,Professional Activity,421,58,479
ANDHRA PRADESH,2007,Farming/Agriculture Activity,1508,289,1797
ANDHRA PRADESH,2007,Others (Please Specify),2462,668,3130
ANDHRA PRADESH,2007,Retired Person,67,11,78
ANDHRA PRADESH,2007,Others (Please Specify),2273,676,2949
ANDHRA PRADESH,2007,Total,9949,4933,14882
ANDHRA PRADESH,2007,Total Salaried,1533,354,1887
ANDHRA PRADESH,2007,Total Self-employed,5316,1070,6386
ANDHRA PRADESH,2008,House Wife,0,2516,2516
ANDHRA PRADESH,2008,Service (Government),246,59,305
ANDHRA PRADESH,2008,Service (Private),968,189,1157
ANDHRA PRADESH,2008,Public Sector Undertaking,531,110,641
ANDHRA PRADESH,2008,Student,294,187,481
ANDHRA PRADESH,2008,Unemployed,519,52,571
ANDHRA PRADESH,2008,Self-employed (Business activity),935,30,965
ANDHRA PRADESH,2008,Professional Activity,459,33,492
ANDHRA PRADESH,2008,Farming/Agriculture Activity,1747,358,2105
ANDHRA PRADESH,2008,Others (Please Specify),1956,580,2536
ANDHRA PRADESH,2008,Retired Person,52,15,67
ANDHRA PRADESH,2008,Others (Please Specify),2014,504,2518
ANDHRA PRADESH,2008,Total,9721,4633,14354
ANDHRA PRADESH,2008,Total Salaried,1745,358,2103
ANDHRA PRADESH,2008,Total Self-employed,5097,1001,6098
ANDHRA PRADESH,2009,House Wife,0,2391,2391
ANDHRA PRADESH,2009,Service (Government),213,21,234
ANDHRA PRADESH,2009,Service (Private),1046,161,1207
ANDHRA PRADESH,2009,Public Sector Undertaking,587,78,665
ANDHRA PRADESH,2009,Student,364,233,597
ANDHRA PRADESH,2009,Unemployed,644,70,714
ANDHRA PRADESH,2009,Self-employed (Business activity),1326,25,1351
ANDHRA PRADESH,2009,Professional Activity,466,23,489
ANDHRA PRADESH,2009,Farming/Agriculture Activity,2016,398,2414
ANDHRA PRADESH,2009,Others (Please Specify),1946,670,2616
ANDHRA PRADESH,2009,Retired Person,69,29,98
ANDHRA PRADESH,2009,Others (Please Specify),1210,514,1724
ANDHRA PRADESH,2009,Total,9887,4613,14500
ANDHRA PRADESH,2009,Total Salaried,1846,260,2106
ANDHRA PRADESH,2009,Total Self-employed,5754,1116,6870
ANDHRA PRADESH,2010,House Wife,0,2601,2601
ANDHRA PRADESH,2010,Service (Government),187,72,259
ANDHRA PRADESH,2010,Service (Private),929,114,1043
ANDHRA PRADESH,2010,Public Sector Undertaking,485,47,532
ANDHRA PRADESH,2010,Student,374,282,656
ANDHRA PRADESH,2010,Unemployed,561,75,636
ANDHRA PRADESH,2010,Self-employed (Business activity),937,58,995
ANDHRA PRADESH,2010,Professional Activity,218,10,228
ANDHRA PRADESH,2010,Farming/Agriculture Activity,2130,395,2525
ANDHRA PRADESH,2010,Others (Please Specify),3473,747,4220
ANDHRA PRADESH,2010,Retired Person,66,18,84
ANDHRA PRADESH,2010,Others (Please Specify),1587,535,2122
ANDHRA PRADESH,2010,Total,10947,4954,15901
ANDHRA PRADESH,2010,Total Salaried,1601,233,1834
ANDHRA PRADESH,2010,Total Self-employed,6758,1210,7968
ANDHRA PRADESH,2011,House Wife,0,2288,2288
ANDHRA PRADESH,2011,Service (Government),89,20,109
ANDHRA PRADESH,2011,Service (Private),1387,243,1630
ANDHRA PRADESH,2011,Public Sector Undertaking,288,79,367
ANDHRA PRADESH,2011,Student,287,276,563
ANDHRA PRADESH,2011,Unemployed,535,107,642
ANDHRA PRADESH,2011,Self-employed (Business activity),961,133,1094
ANDHRA PRADESH,2011,Professional Activity,340,52,392
ANDHRA PRADESH,2011,Farming/Agriculture Activity,1822,384,2206
ANDHRA PRADESH,2011,Others (Please Specify),2483,813,3296
ANDHRA PRADESH,2011,Retired Person,35,6,41
ANDHRA PRADESH,2011,Others (Please Specify),1893,556,2449
ANDHRA PRADESH,2011,Total,10120,4957,15077
ANDHRA PRADESH,2011,Total Salaried,1764,342,2106
ANDHRA PRADESH,2011,Total Self-employed,5606,1382,6988
ANDHRA PRADESH,2012,House Wife,0,2143,2143
ANDHRA PRADESH,2012,Service (Government),108,29,137
ANDHRA PRADESH,2012,Service (Private),1268,185,1453
ANDHRA PRADESH,2012,Public Sector Undertaking,280,51,331
ANDHRA PRADESH,2012,Student,276,283,559
ANDHRA PRADESH,2012,Unemployed,640,127,767
ANDHRA PRADESH,2012,Self-employed (Business activity),721,30,751
ANDHRA PRADESH,2012,Professional Activity,334,31,365
ANDHRA PRADESH,2012,Farming/Agriculture Activity,2100,472,2572
ANDHRA PRADESH,2012,Others (Please Specify),2521,813,3334
ANDHRA PRADESH,2012,Retired Person,84,0,84
ANDHRA PRADESH,2012,Others (Please Specify),1195,547,1742
ANDHRA PRADESH,2012,Total,9527,4711,14238
ANDHRA PRADESH,2012,Total Salaried,1656,265,1921
ANDHRA PRADESH,2012,Total Self-employed,5676,1346,7022
ARUNACHAL PRADESH,2001,House Wife,0,15,15
ARUNACHAL PRADESH,2001,Service (Government),14,0,14
ARUNACHAL PRADESH,2001,Service (Private),32,9,41
ARUNACHAL PRADESH,2001,Public Sector Undertaking,0,0,0
ARUNACHAL PRADESH,2001,Student,2,6,8
ARUNACHAL PRADESH,2001,Unemployed,3,0,3
ARUNACHAL PRADESH,2001,Self-employed (Business activity),12,0,12
ARUNACHAL PRADESH,2001,Professional Activity,0,0,0
ARUNACHAL PRADESH,2001,Farming/Agriculture Activity,12,5,17
ARUNACHAL PRADESH,2001,Others (Please Specify),0,0,0
ARUNACHAL PRADESH,2001,Retired Person,1,0,1
ARUNACHAL PRADESH,2001,Others (Please Specify),0,0,0
ARUNACHAL PRADESH,2001,Total,76,35,111
ARUNACHAL PRADESH,2001,Total Salaried,46,9,55
ARUNACHAL PRADESH,2001,Total Self-employed,24,5,29
ARUNACHAL PRADESH,2002,House Wife,0,27,27
ARUNACHAL PRADESH,2002,Service (Government),15,0,15
ARUNACHAL PRADESH,2002,Service (Private),13,0,13
ARUNACHAL PRADESH,2002,Public Sector Undertaking,0,0,0
ARUNACHAL PRADESH,2002,Student,4,5,9
ARUNACHAL PRADESH,2002,Unemployed,2,4,6
ARUNACHAL PRADESH,2002,Self-employed (Business activity),14,1,15
ARUNACHAL PRADESH,2002,Professional Activity,1,0,1
ARUNACHAL PRADESH,2002,Farming/Agriculture Activity,21,6,27
ARUNACHAL PRADESH,2002,Others (Please Specify),0,0,0
ARUNACHAL PRADESH,2002,Retired Person,1,0,1
ARUNACHAL PRADESH,2002,Others (Please Specify),0,0,0
ARUNACHAL PRADESH,2002,Total,71,43,114
ARUNACHAL PRADESH,2002,Total Salaried,28,0,28
ARUNACHAL PRADESH,2002,Total Self-employed,36,7,43
ARUNACHAL PRADESH,2003,House Wife,0,18,18
ARUNACHAL PRADESH,2003,Service (Government),12,2,14
ARUNACHAL PRADESH,2003,Service (Private),3,0,3
ARUNACHAL PRADESH,2003,Public Sector Undertaking,1,0,1
ARUNACHAL PRADESH,2003,Student,1,4,5
ARUNACHAL PRADESH,2003,Unemployed,3,0,3
ARUNACHAL PRADESH,2003,Self-employed (Business activity),24,2,26
ARUNACHAL PRADESH,2003,Professional Activity,0,0,0
ARUNACHAL PRADESH,2003,Farming/Agriculture Activity,10,1,11
ARUNACHAL PRADESH,2003,Others (Please Specify),0,0,0
ARUNACHAL PRADESH,2003,Retired Person,0,0,0
ARUNACHAL PRADESH,2003,Others (Please Specify),0,0,0
ARUNACHAL PRADESH,2003,Total,54,27,81
ARUNACHAL PRADESH,2003,Total Salaried,16,2,18
ARUNACHAL PRADESH,2003,Total Self-employed,34,3,37
ARUNACHAL PRADESH,2004,House Wife,0,17,17
ARUNACHAL PRADESH,2004,Service (Government),10,1,11
ARUNACHAL PRADESH,2004,Service (Private),2,0,2
ARUNACHAL PRADESH,2004,Public Sector Undertaking,0,0,0
ARUNACHAL PRADESH,2004,Student,5,5,10
ARUNACHAL PRADESH,2004,Unemployed,2,3,5
ARUNACHAL PRADESH,2004,Self-employed (Business activity),14,0,14
ARUNACHAL PRADESH,2004,Professional Activity,0,0,0
ARUNACHAL PRADESH,2004,Farming/Agriculture Activity,16,4,20
ARUNACHAL PRADESH,2004,Others (Please Specify),0,0,0
ARUNACHAL PRADESH,2004,Retired Person,0,0,0
ARUNACHAL PRADESH,2004,Others (Please Specify),0,0,0
ARUNACHAL PRADESH,2004,Total,49,30,79
ARUNACHAL PRADESH,2004,Total Salaried,12,1,13
ARUNACHAL PRADESH,2004,Total Self-employed,30,4,34
ARUNACHAL PRADESH,2005,House Wife,0,9,9
ARUNACHAL PRADESH,2005,Service (Government),3,1,4
ARUNACHAL PRADESH,2005,Service (Private),4,1,5
ARUNACHAL PRADESH,2005,Public Sector Undertaking,0,0,0
ARUNACHAL PRADESH,2005,Student,1,1,2
ARUNACHAL PRADESH,2005,Unemployed,4,1,5
ARUNACHAL PRADESH,2005,Self-employed (Business activity),18,1,19
ARUNACHAL PRADESH,2005,Professional Activity,1,0,1
ARUNACHAL PRADESH,2005,Farming/Agriculture Activity,18,7,25
ARUNACHAL PRADESH,2005,Others (Please Specify),0,0,0
ARUNACHAL PRADESH,2005,Retired Person,0,0,0
ARUNACHAL PRADESH,2005,Others (Please Specify),0,0,0
ARUNACHAL PRADESH,2005,Total,49,21,70
ARUNACHAL PRADESH,2005,Total Salaried,7,2,9
ARUNACHAL PRADESH,2005,Total Self-employed,37,8,45
ARUNACHAL PRADESH,2006,House Wife,0,21,21
ARUNACHAL PRADESH,2006,Service (Government),18,1,19
ARUNACHAL PRADESH,2006,Service (Private),28,0,28
ARUNACHAL PRADESH,2006,Public Sector Undertaking,0,0,0
ARUNACHAL PRADESH,2006,Student,2,8,10
ARUNACHAL PRADESH,2006,Unemployed,9,0,9
ARUNACHAL PRADESH,2006,Self-employed (Business activity),5,0,5
ARUNACHAL PRADESH,2006,Professional Activity,0,0,0
ARUNACHAL PRADESH,2006,Farming/Agriculture Activity,4,0,4
ARUNACHAL PRADESH,2006,Others (Please Specify),23,3,26
ARUNACHAL PRADESH,2006,Retired Person,0,0,0
ARUNACHAL PRADESH,2006,Others (Please Specify),7,0,7
ARUNACHAL PRADESH,2006,Total,96,33,129
ARUNACHAL PRADESH,2006,Total Salaried,46,1,47
ARUNACHAL PRADESH,2006,Total Self-employed,32,3,35
ARUNACHAL PRADESH,2007,House Wife,0,10,10
ARUNACHAL PRADESH,2007,Service (Government),9,0,9
ARUNACHAL PRADESH,2007,Service (Private),18,1,19
ARUNACHAL PRADESH,2007,Public Sector Undertaking,0,0,0
ARUNACHAL PRADESH,2007,Student,3,8,11
ARUNACHAL PRADESH,2007,Unemployed,25,2,27
ARUNACHAL PRADESH,2007,Self-employed (Business activity),4,0,4
ARUNACHAL PRADESH,2007,Professional Activity,1,0,1
ARUNACHAL PRADESH,2007,Farming/Agriculture Activity,14,1,15
ARUNACHAL PRADESH,2007,Others (Please Specify),16,5,21
ARUNACHAL PRADESH,2007,Retired Person,2,0,2
ARUNACHAL PRADESH,2007,Others (Please Specify),6,4,10
ARUNACHAL PRADESH,2007,Total,98,31,129
ARUNACHAL PRADESH,2007,Total Salaried,27,1,28
ARUNACHAL PRADESH,2007,Total Self-employed,35,6,41
ARUNACHAL PRADESH,2008,House Wife,0,14,14
ARUNACHAL PRADESH,2008,Service (Government),25,1,26
ARUNACHAL PRADESH,2008,Service (Private),5,3,8
ARUNACHAL PRADESH,2008,Public Sector Undertaking,0,0,0
ARUNACHAL PRADESH,2008,Student,2,3,5
ARUNACHAL PRADESH,2008,Unemployed,11,1,12
ARUNACHAL PRADESH,2008,Self-employed (Business activity),0,0,0
ARUNACHAL PRADESH,2008,Professional Activity,0,0,0
ARUNACHAL PRADESH,2008,Farming/Agriculture Activity,12,0,12
ARUNACHAL PRADESH,2008,Others (Please Specify),20,11,31
ARUNACHAL PRADESH,2008,Retired Person,0,0,0
ARUNACHAL PRADESH,2008,Others (Please Specify),2,0,2
ARUNACHAL PRADESH,2008,Total,77,33,110
ARUNACHAL PRADESH,2008,Total Salaried,30,4,34
ARUNACHAL PRADESH,2008,Total Self-employed,32,11,43
ARUNACHAL PRADESH,2009,House Wife,0,14,14
ARUNACHAL PRADESH,2009,Service (Government),25,1,26
ARUNACHAL PRADESH,2009,Service (Private),5,3,8
ARUNACHAL PRADESH,2009,Public Sector Undertaking,0,0,0
ARUNACHAL PRADESH,2009,Student,2,3,5
ARUNACHAL PRADESH,2009,Unemployed,11,1,12
ARUNACHAL PRADESH,2009,Self-employed (Business activity),0,0,0
ARUNACHAL PRADESH,2009,Professional Activity,0,0,0
ARUNACHAL PRADESH,2009,Farming/Agriculture Activity,12,0,12
ARUNACHAL PRADESH,2009,Others (Please Specify),20,11,31
ARUNACHAL PRADESH,2009,Retired Person,0,0,0
ARUNACHAL PRADESH,2009,Others (Please Specify),2,0,2
ARUNACHAL PRADESH,2009,Total,77,33,110
ARUNACHAL PRADESH,2009,Total Salaried,30,4,34
ARUNACHAL PRADESH,2009,Total Self-employed,32,11,43
ARUNACHAL PRADESH,2010,House Wife,0,17,17
ARUNACHAL PRADESH,2010,Service (Government),11,0,11
ARUNACHAL PRADESH,2010,Service (Private),9,1,10
ARUNACHAL PRADESH,2010,Public Sector Undertaking,0,0,0
ARUNACHAL PRADESH,2010,Student,8,8,16
ARUNACHAL PRADESH,2010,Unemployed,6,1,7
ARUNACHAL PRADESH,2010,Self-employed (Business activity),4,0,4
ARUNACHAL PRADESH,2010,Professional Activity,0,0,0
ARUNACHAL PRADESH,2010,Farming/Agriculture Activity,18,0,18
ARUNACHAL PRADESH,2010,Others (Please Specify),12,0,12
ARUNACHAL PRADESH,2010,Retired Person,0,0,0
ARUNACHAL PRADESH,2010,Others (Please Specify),23,13,36
ARUNACHAL PRADESH,2010,Total,91,40,131
ARUNACHAL PRADESH,2010,Total Salaried,20,1,21
ARUNACHAL PRADESH,2010,Total Self-employed,34,0,34
ARUNACHAL PRADESH,2011,House Wife,0,21,21
ARUNACHAL PRADESH,2011,Service (Government),16,0,16
ARUNACHAL PRADESH,2011,Service (Private),15,0,15
ARUNACHAL PRADESH,2011,Public Sector Undertaking,9,0,9
ARUNACHAL PRADESH,2011,Student,10,5,15
ARUNACHAL PRADESH,2011,Unemployed,7,3,10
ARUNACHAL PRADESH,2011,Self-employed (Business activity),9,0,9
ARUNACHAL PRADESH,2011,Professional Activity,0,0,0
ARUNACHAL PRADESH,2011,Farming/Agriculture Activity,12,1,13
ARUNACHAL PRADESH,2011,Others (Please Specify),13,5,18
ARUNACHAL PRADESH,2011,Retired Person,1,0,1
ARUNACHAL PRADESH,2011,Others (Please Specify),7,0,7
ARUNACHAL PRADESH,2011,Total,99,35,134
ARUNACHAL PRADESH,2011,Total Salaried,40,0,40
ARUNACHAL PRADESH,2011,Total Self-employed,34,6,40
ARUNACHAL PRADESH,2012,House Wife,0,19,19
ARUNACHAL PRADESH,2012,Service (Government),4,5,9
ARUNACHAL PRADESH,2012,Service (Private),29,1,30
ARUNACHAL PRADESH,2012,Public Sector Undertaking,2,0,2
ARUNACHAL PRADESH,2012,Student,10,3,13
ARUNACHAL PRADESH,2012,Unemployed,16,0,16
ARUNACHAL PRADESH,2012,Self-employed (Business activity),0,0,0
ARUNACHAL PRADESH,2012,Professional Activity,0,0,0
ARUNACHAL PRADESH,2012,Farming/Agriculture Activity,11,0,11
ARUNACHAL PRADESH,2012,Others (Please Specify),19,2,21
ARUNACHAL PRADESH,2012,Retired Person,0,0,0
ARUNACHAL PRADESH,2012,Others (Please Specify),9,0,9
ARUNACHAL PRADESH,2012,Total,100,30,130
ARUNACHAL PRADESH,2012,Total Salaried,35,6,41
ARUNACHAL PRADESH,2012,Total Self-employed,30,2,32
ASSAM,2001,House Wife,0,394,394
ASSAM,2001,Service (Government),45,2,47
ASSAM,2001,Service (Private),131,28,159
ASSAM,2001,Public Sector Undertaking,84,2,86
ASSAM,2001,Student,121,70,191
ASSAM,2001,Unemployed,296,38,334
ASSAM,2001,Self-employed (Business activity),199,24,223
ASSAM,2001,Professional Activity,67,1,68
ASSAM,2001,Farming/Agriculture Activity,144,23,167
ASSAM,2001,Others (Please Specify),437,130,567
ASSAM,2001,Retired Person,6,0,6
ASSAM,2001,Others (Please Specify),306,99,405
ASSAM,2001,Total,1836,811,2647
ASSAM,2001,Total Salaried,260,32,292
ASSAM,2001,Total Self-employed,847,178,1025
ASSAM,2002,House Wife,0,485,485
ASSAM,2002,Service (Government),14,4,18
ASSAM,2002,Service (Private),79,12,91
ASSAM,2002,Public Sector Undertaking,64,8,72
ASSAM,2002,Student,88,29,117
ASSAM,2002,Unemployed,231,31,262
ASSAM,2002,Self-employed (Business activity),239,20,259
ASSAM,2002,Professional Activity,42,0,42
ASSAM,2002,Farming/Agriculture Activity,248,23,271
ASSAM,2002,Others (Please Specify),437,123,560
ASSAM,2002,Retired Person,6,0,6
ASSAM,2002,Others (Please Specify),254,73,327
ASSAM,2002,Total,1702,808,2510
ASSAM,2002,Total Salaried,157,24,181
ASSAM,2002,Total Self-employed,966,166,1132
ASSAM,2003,House Wife,0,381,381
ASSAM,2003,Service (Government),15,0,15
ASSAM,2003,Service (Private),88,8,96
ASSAM,2003,Public Sector Undertaking,73,22,95
ASSAM,2003,Student,129,91,220
ASSAM,2003,Unemployed,205,67,272
ASSAM,2003,Self-employed (Business activity),181,26,207
ASSAM,2003,Professional Activity,34,0,34
ASSAM,2003,Farming/Agriculture Activity,156,31,187
ASSAM,2003,Others (Please Specify),595,183,778
ASSAM,2003,Retired Person,1,0,1
ASSAM,2003,Others (Please Specify),199,111,310
ASSAM,2003,Total,1676,920,2596
ASSAM,2003,Total Salaried,176,30,206
ASSAM,2003,Total Self-employed,966,240,1206
ASSAM,2004,House Wife,0,446,446
ASSAM,2004,Service (Government),10,2,12
ASSAM,2004,Service (Private),69,15,84
ASSAM,2004,Public Sector Undertaking,50,15,65
ASSAM,2004,Student,113,62,175
ASSAM,2004,Unemployed,237,62,299
ASSAM,2004,Self-employed (Business activity),300,34,334
ASSAM,2004,Professional Activity,124,0,124
ASSAM,2004,Farming/Agriculture Activity,316,15,331
ASSAM,2004,Others (Please Specify),519,148,667
ASSAM,2004,Retired Person,4,0,4
ASSAM,2004,Others (Please Specify),203,95,298
ASSAM,2004,Total,1945,894,2839
ASSAM,2004,Total Salaried,129,32,161
ASSAM,2004,Total Self-employed,1259,197,1456
ASSAM,2005,House Wife,0,566,566
ASSAM,2005,Service (Government),14,0,14
ASSAM,2005,Service (Private),43,10,53
ASSAM,2005,Public Sector Undertaking,56,4,60
ASSAM,2005,Student,103,51,154
ASSAM,2005,Unemployed,87,9,96
ASSAM,2005,Self-employed (Business activity),350,29,379
ASSAM,2005,Professional Activity,66,3,69
ASSAM,2005,Farming/Agriculture Activity,256,43,299
ASSAM,2005,Others (Please Specify),703,124,827
ASSAM,2005,Retired Person,9,2,11
ASSAM,2005,Others (Please Specify),264,54,318
ASSAM,2005,Total,1951,895,2846
ASSAM,2005,Total Salaried,113,14,127
ASSAM,2005,Total Self-employed,1375,199,1574
ASSAM,2006,House Wife,0,579,579
ASSAM,2006,Service (Government),17,0,17
ASSAM,2006,Service (Private),38,8,46
ASSAM,2006,Public Sector Undertaking,39,14,53
ASSAM,2006,Student,157,53,210
ASSAM,2006,Unemployed,41,0,41
ASSAM,2006,Self-employed (Business activity),466,47,513
ASSAM,2006,Professional Activity,138,0,138
ASSAM,2006,Farming/Agriculture Activity,295,27,322
ASSAM,2006,Others (Please Specify),709,88,797
ASSAM,2006,Retired Person,10,0,10
ASSAM,2006,Others (Please Specify),206,99,305
ASSAM,2006,Total,2116,915,3031
ASSAM,2006,Total Salaried,94,22,116
ASSAM,2006,Total Self-employed,1608,162,1770
ASSAM,2007,House Wife,0,516,516
ASSAM,2007,Service (Government),15,2,17
ASSAM,2007,Service (Private),30,12,42
ASSAM,2007,Public Sector Undertaking,74,19,93
ASSAM,2007,Student,119,90,209
ASSAM,2007,Unemployed,30,6,36
ASSAM,2007,Self-employed (Business activity),377,51,428
ASSAM,2007,Professional Activity,150,0,150
ASSAM,2007,Farming/Agriculture Activity,276,2,278
ASSAM,2007,Others (Please Specify),837,132,969
ASSAM,2007,Retired Person,7,0,7
ASSAM,2007,Others (Please Specify),201,116,317
ASSAM,2007,Total,2116,946,3062
ASSAM,2007,Total Salaried,119,33,152
ASSAM,2007,Total Self-employed,1640,185,1825
ASSAM,2008,House Wife,0,573,573
ASSAM,2008,Service (Government),19,2,21
ASSAM,2008,Service (Private),52,21,73
ASSAM,2008,Public Sector Undertaking,46,7,53
ASSAM,2008,Student,129,77,206
ASSAM,2008,Unemployed,37,7,44
ASSAM,2008,Self-employed (Business activity),375,54,429
ASSAM,2008,Professional Activity,133,4,137
ASSAM,2008,Farming/Agriculture Activity,192,5,197
ASSAM,2008,Others (Please Specify),741,123,864
ASSAM,2008,Retired Person,4,1,5
ASSAM,2008,Others (Please Specify),242,145,387
ASSAM,2008,Total,1970,1019,2989
ASSAM,2008,Total Salaried,117,30,147
ASSAM,2008,Total Self-employed,1441,186,1627
ASSAM,2009,House Wife,0,541,541
ASSAM,2009,Service (Government),5,0,5
ASSAM,2009,Service (Private),56,7,63
ASSAM,2009,Public Sector Undertaking,50,14,64
ASSAM,2009,Student,129,91,220
ASSAM,2009,Unemployed,58,15,73
ASSAM,2009,Self-employed (Business activity),361,59,420
ASSAM,2009,Professional Activity,131,12,143
ASSAM,2009,Farming/Agriculture Activity,317,24,341
ASSAM,2009,Others (Please Specify),584,238,822
ASSAM,2009,Retired Person,13,0,13
ASSAM,2009,Others (Please Specify),178,83,261
ASSAM,2009,Total,1882,1084,2966
ASSAM,2009,Total Salaried,111,21,132
ASSAM,2009,Total Self-employed,1393,333,1726
ASSAM,2010,House Wife,0,415,415
ASSAM,2010,Service (Government),18,1,19
ASSAM,2010,Service (Private),57,16,73
ASSAM,2010,Public Sector Undertaking,98,20,118
ASSAM,2010,Student,148,99,247
ASSAM,2010,Unemployed,66,16,82
ASSAM,2010,Self-employed (Business activity),371,70,441
ASSAM,2010,Professional Activity,136,10,146
ASSAM,2010,Farming/Agriculture Activity,352,17,369
ASSAM,2010,Others (Please Specify),565,238,803
ASSAM,2010,Retired Person,10,0,10
ASSAM,2010,Others (Please Specify),205,65,270
ASSAM,2010,Total,2026,967,2993
ASSAM,2010,Total Salaried,173,37,210
ASSAM,2010,Total Self-employed,1424,335,1759
ASSAM,2011,House Wife,0,490,490
ASSAM,2011,Service (Government),27,1,28
ASSAM,2011,Service (Private),86,12,98
ASSAM,2011,Public Sector Undertaking,91,8,99
ASSAM,2011,Student,160,92,252
ASSAM,2011,Unemployed,48,11,59
ASSAM,2011,Self-employed (Business activity),281,40,321
ASSAM,2011,Professional Activity,85,0,85
ASSAM,2011,Farming/Agriculture Activity,300,12,312
ASSAM,2011,Others (Please Specify),531,124,655
ASSAM,2011,Retired Person,3,0,3
ASSAM,2011,Others (Please Specify),214,110,324
ASSAM,2011,Total,1826,900,2726
ASSAM,2011,Total Salaried,204,21,225
ASSAM,2011,Total Self-employed,1197,176,1373
ASSAM,2012,House Wife,0,403,403
ASSAM,2012,Service (Government),29,25,54
ASSAM,2012,Service (Private),122,11,133
ASSAM,2012,Public Sector Undertaking,107,9,116
ASSAM,2012,Student,124,97,221
ASSAM,2012,Unemployed,64,4,68
ASSAM,2012,Self-employed (Business activity),320,33,353
ASSAM,2012,Professional Activity,110,15,125
ASSAM,2012,Farming/Agriculture Activity,340,4,344
ASSAM,2012,Others (Please Specify),969,180,1149
ASSAM,2012,Retired Person,4,0,4
ASSAM,2012,Others (Please Specify),203,91,294
ASSAM,2012,Total,2392,872,3264
ASSAM,2012,Total Salaried,258,45,303
ASSAM,2012,Total Self-employed,1739,232,1971
BIHAR,2001,House Wife,0,140,140
BIHAR,2001,Service (Government),5,1,6
BIHAR,2001,Service (Private),15,3,18
BIHAR,2001,Public Sector Undertaking,1,0,1
BIHAR,2001,Student,39,25,64
BIHAR,2001,Unemployed,22,16,38
BIHAR,2001,Self-employed (Business activity),14,1,15
BIHAR,2001,Professional Activity,3,0,3
BIHAR,2001,Farming/Agriculture Activity,55,6,61
BIHAR,2001,Others (Please Specify),34,14,48
BIHAR,2001,Retired Person,2,0,2
BIHAR,2001,Others (Please Specify),117,90,207
BIHAR,2001,Total,307,296,603
BIHAR,2001,Total Salaried,21,4,25
BIHAR,2001,Total Self-employed,106,21,127
BIHAR,2002,House Wife,0,148,148
BIHAR,2002,Service (Government),6,0,6
BIHAR,2002,Service (Private),8,8,16
BIHAR,2002,Public Sector Undertaking,1,0,1
BIHAR,2002,Student,40,14,54
BIHAR,2002,Unemployed,57,11,68
BIHAR,2002,Self-employed (Business activity),26,0,26
BIHAR,2002,Professional Activity,5,0,5
BIHAR,2002,Farming/Agriculture Activity,68,12,80
BIHAR,2002,Others (Please Specify),57,18,75
BIHAR,2002,Retired Person,1,0,1
BIHAR,2002,Others (Please Specify),157,83,240
BIHAR,2002,Total,426,294,720
BIHAR,2002,Total Salaried,15,8,23
BIHAR,2002,Total Self-employed,156,30,186
BIHAR,2003,House Wife,0,138,138
BIHAR,2003,Service (Government),3,2,5
BIHAR,2003,Service (Private),21,6,27
BIHAR,2003,Public Sector Undertaking,3,0,3
BIHAR,2003,Student,41,18,59
BIHAR,2003,Unemployed,62,13,75
BIHAR,2003,Self-employed (Business activity),19,2,21
BIHAR,2003,Professional Activity,19,6,25
BIHAR,2003,Farming/Agriculture Activity,45,1,46
BIHAR,2003,Others (Please Specify),48,22,70
BIHAR,2003,Retired Person,6,0,6
BIHAR,2003,Others (Please Specify),84,40,124
BIHAR,2003,Total,351,248,599
BIHAR,2003,Total Salaried,27,8,35
BIHAR,2003,Total Self-employed,131,31,162
BIHAR,2004,House Wife,0,90,90
BIHAR,2004,Service (Government),8,0,8
BIHAR,2004,Service (Private),15,1,16
BIHAR,2004,Public Sector Undertaking,8,0,8
BIHAR,2004,Student,22,10,32
BIHAR,2004,Unemployed,43,7,50
BIHAR,2004,Self-employed (Business activity),16,7,23
BIHAR,2004,Professional Activity,6,0,6
BIHAR,2004,Farming/Agriculture Activity,23,0,23
BIHAR,2004,Others (Please Specify),2,1,3
BIHAR,2004,Retired Person,17,0,17
BIHAR,2004,Others (Please Specify),52,23,75
BIHAR,2004,Total,212,139,351
BIHAR,2004,Total Salaried,31,1,32
BIHAR,2004,Total Self-employed,47,8,55
BIHAR,2005,House Wife,0,109,109
BIHAR,2005,Service (Government),5,1,6
BIHAR,2005,Service (Private),34,2,36
BIHAR,2005,Public Sector Undertaking,9,0,9
BIHAR,2005,Student,33,14,47
BIHAR,2005,Unemployed,23,5,28
BIHAR,2005,Self-employed (Business activity),18,0,18
BIHAR,2005,Professional Activity,19,0,19
BIHAR,2005,Farming/Agriculture Activity,32,7,39
BIHAR,2005,Others (Please Specify),22,9,31
BIHAR,2005,Retired Person,2,2,4
BIHAR,2005,Others (Please Specify),130,67,197
BIHAR,2005,Total,327,216,543
BIHAR,2005,Total Salaried,48,3,51
BIHAR,2005,Total Self-employed,91,16,107
BIHAR,2006,House Wife,0,137,137
BIHAR,2006,Service (Government),6,4,10
BIHAR,2006,Service (Private),15,1,16
BIHAR,2006,Public Sector Undertaking,2,5,7
BIHAR,2006,Student,43,27,70
BIHAR,2006,Unemployed,18,8,26
BIHAR,2006,Self-employed (Business activity),16,8,24
BIHAR,2006,Professional Activity,3,1,4
BIHAR,2006,Farming/Agriculture Activity,38,8,46
BIHAR,2006,Others (Please Specify),42,33,75
BIHAR,2006,Retired Person,1,1,2
BIHAR,2006,Others (Please Specify),115,86,201
BIHAR,2006,Total,299,319,618
BIHAR,2006,Total Salaried,23,10,33
BIHAR,2006,Total Self-employed,99,50,149
BIHAR,2007,House Wife,0,171,171
BIHAR,2007,Service (Government),8,0,8
BIHAR,2007,Service (Private),36,0,36
BIHAR,2007,Public Sector Undertaking,19,0,19
BIHAR,2007,Student,56,59,115
BIHAR,2007,Unemployed,65,19,84
BIHAR,2007,Self-employed (Business activity),8,3,11
BIHAR,2007,Professional Activity,3,0,3
BIHAR,2007,Farming/Agriculture Activity,78,8,86
BIHAR,2007,Others (Please Specify),121,67,188
BIHAR,2007,Retired Person,3,0,3
BIHAR,2007,Others (Please Specify),137,104,241
BIHAR,2007,Total,534,431,965
BIHAR,2007,Total Salaried,63,0,63
BIHAR,2007,Total Self-employed,210,78,288
BIHAR,2008,House Wife,0,174,174
BIHAR,2008,Service (Government),8,0,8
BIHAR,2008,Service (Private),31,4,35
BIHAR,2008,Public Sector Undertaking,13,10,23
BIHAR,2008,Student,42,16,58
BIHAR,2008,Unemployed,49,4,53
BIHAR,2008,Self-employed (Business activity),15,0,15
BIHAR,2008,Professional Activity,5,0,5
BIHAR,2008,Farming/Agriculture Activity,62,5,67
BIHAR,2008,Others (Please Specify),56,55,111
BIHAR,2008,Retired Person,9,6,15
BIHAR,2008,Others (Please Specify),319,132,451
BIHAR,2008,Total,609,406,1015
BIHAR,2008,Total Salaried,52,14,66
BIHAR,2008,Total Self-employed,138,60,198
BIHAR,2009,House Wife,0,314,314
BIHAR,2009,Service (Government),3,0,3
BIHAR,2009,Service (Private),55,2,57
BIHAR,2009,Public Sector Undertaking,8,0,8
BIHAR,2009,Student,42,26,68
BIHAR,2009,Unemployed,43,8,51
BIHAR,2009,Self-employed (Business activity),24,0,24
BIHAR,2009,Professional Activity,3,22,25
BIHAR,2009,Farming/Agriculture Activity,85,27,112
BIHAR,2009,Others (Please Specify),82,6,88
BIHAR,2009,Retired Person,0,0,0
BIHAR,2009,Others (Please Specify),169,132,301
BIHAR,2009,Total,514,537,1051
BIHAR,2009,Total Salaried,66,2,68
BIHAR,2009,Total Self-employed,194,55,249
BIHAR,2010,House Wife,0,204,204
BIHAR,2010,Service (Government),13,8,21
BIHAR,2010,Service (Private),41,8,49
BIHAR,2010,Public Sector Undertaking,2,0,2
BIHAR,2010,Student,39,35,74
BIHAR,2010,Unemployed,73,15,88
BIHAR,2010,Self-employed (Business activity),12,4,16
BIHAR,2010,Professional Activity,5,0,5
BIHAR,2010,Farming/Agriculture Activity,91,4,95
BIHAR,2010,Others (Please Specify),264,51,315
BIHAR,2010,Retired Person,1,2,3
BIHAR,2010,Others (Please Specify),171,183,354
BIHAR,2010,Total,712,514,1226
BIHAR,2010,Total Salaried,56,16,72
BIHAR,2010,Total Self-employed,372,59,431
BIHAR,2011,House Wife,0,138,138
BIHAR,2011,Service (Government),9,20,29
BIHAR,2011,Service (Private),9,0,9
BIHAR,2011,Public Sector Undertaking,3,0,3
BIHAR,2011,Student,36,35,71
BIHAR,2011,Unemployed,49,7,56
BIHAR,2011,Self-employed (Business activity),9,0,9
BIHAR,2011,Professional Activity,7,0,7
BIHAR,2011,Farming/Agriculture Activity,63,20,83
BIHAR,2011,Others (Please Specify),54,28,82
BIHAR,2011,Retired Person,4,0,4
BIHAR,2011,Others (Please Specify),203,101,304
BIHAR,2011,Total,446,349,795
BIHAR,2011,Total Salaried,21,20,41
BIHAR,2011,Total Self-employed,133,48,181
BIHAR,2012,House Wife,0,130,130
BIHAR,2012,Service (Government),12,3,15
BIHAR,2012,Service (Private),22,2,24
BIHAR,2012,Public Sector Undertaking,0,0,0
BIHAR,2012,Student,36,28,64
BIHAR,2012,Unemployed,13,1,14
BIHAR,2012,Self-employed (Business activity),3,0,3
BIHAR,2012,Professional Activity,1,0,1
BIHAR,2012,Farming/Agriculture Activity,64,4,68
BIHAR,2012,Others (Please Specify),43,12,55
BIHAR,2012,Retired Person,1,0,1
BIHAR,2012,Others (Please Specify),260,124,384
BIHAR,2012,Total,455,304,759
BIHAR,2012,Total Salaried,34,5,39
BIHAR,2012,Total Self-employed,111,16,127
CHHATTISGARH,2001,House Wife,0,606,606
CHHATTISGARH,2001,Service (Government),63,7,70
CHHATTISGARH,2001,Service (Private),167,10,177
CHHATTISGARH,2001,Public Sector Undertaking,59,6,65
CHHATTISGARH,2001,Student,134,95,229
CHHATTISGARH,2001,Unemployed,193,25,218
CHHATTISGARH,2001,Self-employed (Business activity),66,2,68
CHHATTISGARH,2001,Professional Activity,32,4,36
CHHATTISGARH,2001,Farming/Agriculture Activity,1198,254,1452
CHHATTISGARH,2001,Others (Please Specify),444,212,656
CHHATTISGARH,2001,Retired Person,13,0,13
CHHATTISGARH,2001,Others (Please Specify),271,164,435
CHHATTISGARH,2001,Total,2640,1385,4025
CHHATTISGARH,2001,Total Salaried,289,23,312
CHHATTISGARH,2001,Total Self-employed,1740,472,2212
CHHATTISGARH,2002,House Wife,0,585,585
CHHATTISGARH,2002,Service (Government),52,12,64
CHHATTISGARH,2002,Service (Private),110,14,124
CHHATTISGARH,2002,Public Sector Undertaking,81,10,91
CHHATTISGARH,2002,Student,122,69,191
CHHATTISGARH,2002,Unemployed,179,33,212
CHHATTISGARH,2002,Self-employed (Business activity),64,0,64
CHHATTISGARH,2002,Professional Activity,41,11,52
CHHATTISGARH,2002,Farming/Agriculture Activity,1054,184,1238
CHHATTISGARH,2002,Others (Please Specify),409,185,594
CHHATTISGARH,2002,Retired Person,7,0,7
CHHATTISGARH,2002,Others (Please Specify),510,218,728
CHHATTISGARH,2002,Total,2629,1321,3950
CHHATTISGARH,2002,Total Salaried,243,36,279
CHHATTISGARH,2002,Total Self-employed,1568,380,1948
CHHATTISGARH,2003,House Wife,0,551,551
CHHATTISGARH,2003,Service (Government),54,3,57
CHHATTISGARH,2003,Service (Private),105,15,120
CHHATTISGARH,2003,Public Sector Undertaking,26,0,26
CHHATTISGARH,2003,Student,125,80,205
CHHATTISGARH,2003,Unemployed,160,24,184
CHHATTISGARH,2003,Self-employed (Business activity),52,5,57
CHHATTISGARH,2003,Professional Activity,97,31,128
CHHATTISGARH,2003,Farming/Agriculture Activity,859,207,1066
CHHATTISGARH,2003,Others (Please Specify),486,139,625
CHHATTISGARH,2003,Retired Person,4,0,4
CHHATTISGARH,2003,Others (Please Specify),624,272,896
CHHATTISGARH,2003,Total,2592,1327,3919
CHHATTISGARH,2003,Total Salaried,185,18,203
CHHATTISGARH,2003,Total Self-employed,1494,382,1876
CHHATTISGARH,2004,House Wife,0,777,777
CHHATTISGARH,2004,Service (Government),35,2,37
CHHATTISGARH,2004,Service (Private),80,2,82
CHHATTISGARH,2004,Public Sector Undertaking,15,1,16
CHHATTISGARH,2004,Student,138,88,226
CHHATTISGARH,2004,Unemployed,161,3,164
CHHATTISGARH,2004,Self-employed (Business activity),45,0,45
CHHATTISGARH,2004,Professional Activity,47,6,53
CHHATTISGARH,2004,Farming/Agriculture Activity,1213,182,1395
CHHATTISGARH,2004,Others (Please Specify),683,190,873
CHHATTISGARH,2004,Retired Person,0,0,0
CHHATTISGARH,2004,Others (Please Specify),569,258,827
CHHATTISGARH,2004,Total,2986,1509,4495
CHHATTISGARH,2004,Total Salaried,130,5,135
CHHATTISGARH,2004,Total Self-employed,1988,378,2366
CHHATTISGARH,2005,House Wife,0,891,891
CHHATTISGARH,2005,Service (Government),58,6,64
CHHATTISGARH,2005,Service (Private),178,17,195
CHHATTISGARH,2005,Public Sector Undertaking,33,15,48
CHHATTISGARH,2005,Student,116,72,188
CHHATTISGARH,2005,Unemployed,228,25,253
CHHATTISGARH,2005,Self-employed (Business activity),147,27,174
CHHATTISGARH,2005,Professional Activity,131,9,140
CHHATTISGARH,2005,Farming/Agriculture Activity,1200,212,1412
CHHATTISGARH,2005,Others (Please Specify),410,117,527
CHHATTISGARH,2005,Retired Person,11,1,12
CHHATTISGARH,2005,Others (Please Specify),793,184,977
CHHATTISGARH,2005,Total,3305,1576,4881
CHHATTISGARH,2005,Total Salaried,269,38,307
CHHATTISGARH,2005,Total Self-employed,1888,365,2253
CHHATTISGARH,2006,House Wife,0,772,772
CHHATTISGARH,2006,Service (Government),31,4,35
CHHATTISGARH,2006,Service (Private),127,9,136
CHHATTISGARH,2006,Public Sector Undertaking,16,1,17
CHHATTISGARH,2006,Student,107,85,192
CHHATTISGARH,2006,Unemployed,144,8,152
CHHATTISGARH,2006,Self-employed (Business activity),113,22,135
CHHATTISGARH,2006,Professional Activity,83,0,83
CHHATTISGARH,2006,Farming/Agriculture Activity,1212,271,1483
CHHATTISGARH,2006,Others (Please Specify),507,156,663
CHHATTISGARH,2006,Retired Person,1,0,1
CHHATTISGARH,2006,Others (Please Specify),719,238,957
CHHATTISGARH,2006,Total,3060,1566,4626
CHHATTISGARH,2006,Total Salaried,174,14,188
CHHATTISGARH,2006,Total Self-employed,1915,449,2364
CHHATTISGARH,2007,House Wife,0,848,848
CHHATTISGARH,2007,Service (Government),34,4,38
CHHATTISGARH,2007,Service (Private),213,20,233
CHHATTISGARH,2007,Public Sector Undertaking,22,2,24
CHHATTISGARH,2007,Student,172,107,279
CHHATTISGARH,2007,Unemployed,177,14,191
CHHATTISGARH,2007,Self-employed (Business activity),132,3,135
CHHATTISGARH,2007,Professional Activity,103,6,109
CHHATTISGARH,2007,Farming/Agriculture Activity,1264,329,1593
CHHATTISGARH,2007,Others (Please Specify),510,154,664
CHHATTISGARH,2007,Retired Person,2,0,2
CHHATTISGARH,2007,Others (Please Specify),627,96,723
CHHATTISGARH,2007,Total,3256,1583,4839
CHHATTISGARH,2007,Total Salaried,269,26,295
CHHATTISGARH,2007,Total Self-employed,2009,492,2501
CHHATTISGARH,2008,House Wife,0,937,937
CHHATTISGARH,2008,Service (Government),39,6,45
CHHATTISGARH,2008,Service (Private),183,18,201
CHHATTISGARH,2008,Public Sector Undertaking,10,0,10
CHHATTISGARH,2008,Student,202,168,370
CHHATTISGARH,2008,Unemployed,167,10,177
CHHATTISGARH,2008,Self-employed (Business activity),153,4,157
CHHATTISGARH,2008,Professional Activity,80,13,93
CHHATTISGARH,2008,Farming/Agriculture Activity,1491,282,1773
CHHATTISGARH,2008,Others (Please Specify),662,164,826
CHHATTISGARH,2008,Retired Person,2,0,2
CHHATTISGARH,2008,Others (Please Specify),259,95,354
CHHATTISGARH,2008,Total,3248,1697,4945
CHHATTISGARH,2008,Total Salaried,232,24,256
CHHATTISGARH,2008,Total Self-employed,2386,463,2849
CHHATTISGARH,2009,House Wife,0,902,902
CHHATTISGARH,2009,Service (Government),42,6,48
CHHATTISGARH,2009,Service (Private),249,45,294
CHHATTISGARH,2009,Public Sector Undertaking,17,0,17
CHHATTISGARH,2009,Student,298,137,435
CHHATTISGARH,2009,Unemployed,461,28,489
CHHATTISGARH,2009,Self-employed (Business activity),104,4,108
CHHATTISGARH,2009,Professional Activity,131,6,137
CHHATTISGARH,2009,Farming/Agriculture Activity,1417,385,1802
CHHATTISGARH,2009,Others (Please Specify),683,178,861
CHHATTISGARH,2009,Retired Person,6,3,9
CHHATTISGARH,2009,Others (Please Specify),546,235,781
CHHATTISGARH,2009,Total,3954,1929,5883
CHHATTISGARH,2009,Total Salaried,308,51,359
CHHATTISGARH,2009,Total Self-employed,2335,573,2908
CHHATTISGARH,2010,House Wife,0,862,862
CHHATTISGARH,2010,Service (Government),38,2,40
CHHATTISGARH,2010,Service (Private),287,44,331
CHHATTISGARH,2010,Public Sector Undertaking,44,0,44
CHHATTISGARH,2010,Student,223,154,377
CHHATTISGARH,2010,Unemployed,593,19,612
CHHATTISGARH,2010,Self-employed (Business activity),98,6,104
CHHATTISGARH,2010,Professional Activity,231,4,235
CHHATTISGARH,2010,Farming/Agriculture Activity,778,348,1126
CHHATTISGARH,2010,Others (Please Specify),1303,284,1587
CHHATTISGARH,2010,Retired Person,1,0,1
CHHATTISGARH,2010,Others (Please Specify),949,254,1203
CHHATTISGARH,2010,Total,4545,1977,6522
CHHATTISGARH,2010,Total Salaried,369,46,415
CHHATTISGARH,2010,Total Self-employed,2410,642,3052
CHHATTISGARH,2011,House Wife,0,775,775
CHHATTISGARH,2011,Service (Government),46,8,54
CHHATTISGARH,2011,Service (Private),321,89,410
CHHATTISGARH,2011,Public Sector Undertaking,61,11,72
CHHATTISGARH,2011,Student,201,161,362
CHHATTISGARH,2011,Unemployed,592,34,626
CHHATTISGARH,2011,Self-employed (Business activity),218,10,228
CHHATTISGARH,2011,Professional Activity,154,56,210
CHHATTISGARH,2011,Farming/Agriculture Activity,0,0,0
CHHATTISGARH,2011,Others (Please Specify),1955,657,2612
CHHATTISGARH,2011,Retired Person,19,0,19
CHHATTISGARH,2011,Others (Please Specify),960,428,1388
CHHATTISGARH,2011,Total,4527,2229,6756
CHHATTISGARH,2011,Total Salaried,428,108,536
CHHATTISGARH,2011,Total Self-employed,2327,723,3050
CHHATTISGARH,2012,House Wife,0,779,779
CHHATTISGARH,2012,Service (Government),62,4,66
CHHATTISGARH,2012,Service (Private),351,55,406
CHHATTISGARH,2012,Public Sector Undertaking,10,0,10
CHHATTISGARH,2012,Student,161,129,290
CHHATTISGARH,2012,Unemployed,341,18,359
CHHATTISGARH,2012,Self-employed (Business activity),106,4,110
CHHATTISGARH,2012,Professional Activity,229,0,229
CHHATTISGARH,2012,Farming/Agriculture Activity,4,0,4
CHHATTISGARH,2012,Others (Please Specify),1504,322,1826
CHHATTISGARH,2012,Retired Person,17,0,17
CHHATTISGARH,2012,Others (Please Specify),1229,329,1558
CHHATTISGARH,2012,Total,4014,1640,5654
CHHATTISGARH,2012,Total Salaried,423,59,482
CHHATTISGARH,2012,Total Self-employed,1843,326,2169
GOA,2001,House Wife,0,55,55
GOA,2001,Service (Government),4,2,6
GOA,2001,Service (Private),46,6,52
GOA,2001,Public Sector Undertaking,0,0,0
GOA,2001,Student,4,9,13
GOA,2001,Unemployed,44,10,54
GOA,2001,Self-employed (Business activity),10,0,10
GOA,2001,Professional Activity,2,0,2
GOA,2001,Farming/Agriculture Activity,18,0,18
GOA,2001,Others (Please Specify),11,4,15
GOA,2001,Retired Person,3,0,3
GOA,2001,Others (Please Specify),25,3,28
GOA,2001,Total,167,89,256
GOA,2001,Total Salaried,50,8,58
GOA,2001,Total Self-employed,41,4,45
GOA,2002,House Wife,0,42,42
GOA,2002,Service (Government),4,3,7
GOA,2002,Service (Private),55,8,63
GOA,2002,Public Sector Undertaking,4,0,4
GOA,2002,Student,8,9,17
GOA,2002,Unemployed,65,8,73
GOA,2002,Self-employed (Business activity),11,0,11
GOA,2002,Professional Activity,2,0,2
GOA,2002,Farming/Agriculture Activity,9,2,11
GOA,2002,Others (Please Specify),17,0,17
GOA,2002,Retired Person,5,0,5
GOA,2002,Others (Please Specify),46,11,57
GOA,2002,Total,226,83,309
GOA,2002,Total Salaried,63,11,74
GOA,2002,Total Self-employed,39,2,41
GOA,2003,House Wife,0,49,49
GOA,2003,Service (Government),7,1,8
GOA,2003,Service (Private),62,10,72
GOA,2003,Public Sector Undertaking,1,0,1
GOA,2003,Student,12,7,19
GOA,2003,Unemployed,47,11,58
GOA,2003,Self-employed (Business activity),16,2,18
GOA,2003,Professional Activity,2,1,3
GOA,2003,Farming/Agriculture Activity,17,1,18
GOA,2003,Others (Please Specify),17,1,18
GOA,2003,Retired Person,0,0,0
GOA,2003,Others (Please Specify),32,4,36
GOA,2003,Total,213,87,300
GOA,2003,Total Salaried,70,11,81
GOA,2003,Total Self-employed,52,5,57
GOA,2004,House Wife,0,55,55
GOA,2004,Service (Government),7,3,10
GOA,2004,Service (Private),39,7,46
GOA,2004,Public Sector Undertaking,10,3,13
GOA,2004,Student,13,10,23
GOA,2004,Unemployed,48,11,59
GOA,2004,Self-employed (Business activity),12,2,14
GOA,2004,Professional Activity,1,1,2
GOA,2004,Farming/Agriculture Activity,7,1,8
GOA,2004,Others (Please Specify),10,0,10
GOA,2004,Retired Person,3,0,3
GOA,2004,Others (Please Specify),62,9,71
GOA,2004,Total,212,102,314
GOA,2004,Total Salaried,56,13,69
GOA,2004,Total Self-employed,30,4,34
GOA,2005,House Wife,0,47,47
GOA,2005,Service (Government),7,0,7
GOA,2005,Service (Private),46,6,52
GOA,2005,Public Sector Undertaking,6,0,6
GOA,2005,Student,8,7,15
GOA,2005,Unemployed,45,13,58
GOA,2005,Self-employed (Business activity),8,1,9
GOA,2005,Professional Activity,1,0,1
GOA,2005,Farming/Agriculture Activity,10,1,11
GOA,2005,Others (Please Specify),13,1,14
GOA,2005,Retired Person,4,1,5
GOA,2005,Others (Please Specify),49,8,57
GOA,2005,Total,197,85,282
GOA,2005,Total Salaried,59,6,65
GOA,2005,Total Self-employed,32,3,35
GOA,2006,House Wife,0,51,51
GOA,2006,Service (Government),3,0,3
GOA,2006,Service (Private),49,4,53
GOA,2006,Public Sector Undertaking,0,0,0
GOA,2006,Student,8,12,20
GOA,2006,Unemployed,51,12,63
GOA,2006,Self-employed (Business activity),9,0,9
GOA,2006,Professional Activity,0,0,0
GOA,2006,Farming/Agriculture Activity,5,0,5
GOA,2006,Others (Please Specify),13,1,14
GOA,2006,Retired Person,8,0,8
GOA,2006,Others (Please Specify),37,12,49
GOA,2006,Total,183,92,275
GOA,2006,Total Salaried,52,4,56
GOA,2006,Total Self-employed,27,1,28
GOA,2007,House Wife,0,59,59
GOA,2007,Service (Government),3,3,6
GOA,2007,Service (Private),55,9,64
GOA,2007,Public Sector Undertaking,0,0,0
GOA,2007,Student,14,4,18
GOA,2007,Unemployed,67,14,81
GOA,2007,Self-employed (Business activity),16,0,16
GOA,2007,Professional Activity,1,0,1
GOA,2007,Farming/Agriculture Activity,0,0,0
GOA,2007,Others (Please Specify),4,0,4
GOA,2007,Retired Person,10,0,10
GOA,2007,Others (Please Specify),8,3,11
GOA,2007,Total,178,92,270
GOA,2007,Total Salaried,58,12,70
GOA,2007,Total Self-employed,21,0,21
GOA,2008,House Wife,0,65,65
GOA,2008,Service (Government),3,1,4
GOA,2008,Service (Private),56,7,63
GOA,2008,Public Sector Undertaking,0,0,0
GOA,2008,Student,5,7,12
GOA,2008,Unemployed,54,17,71
GOA,2008,Self-employed (Business activity),11,1,12
GOA,2008,Professional Activity,1,0,1
GOA,2008,Farming/Agriculture Activity,6,0,6
GOA,2008,Others (Please Specify),8,1,9
GOA,2008,Retired Person,2,0,2
GOA,2008,Others (Please Specify),37,5,42
GOA,2008,Total,183,104,287
GOA,2008,Total Salaried,59,8,67
GOA,2008,Total Self-employed,26,2,28
GOA,2009,House Wife,0,60,60
GOA,2009,Service (Government),5,5,10
GOA,2009,Service (Private),44,6,50
GOA,2009,Public Sector Undertaking,3,0,3
GOA,2009,Student,8,7,15
GOA,2009,Unemployed,53,6,59
GOA,2009,Self-employed (Business activity),4,2,6
GOA,2009,Professional Activity,4,1,5
GOA,2009,Farming/Agriculture Activity,4,0,4
GOA,2009,Others (Please Specify),19,4,23
GOA,2009,Retired Person,4,0,4
GOA,2009,Others (Please Specify),36,3,39
GOA,2009,Total,184,94,278
GOA,2009,Total Salaried,52,11,63
GOA,2009,Total Self-employed,31,7,38
GOA,2010,House Wife,0,52,52
GOA,2010,Service (Government),9,0,9
GOA,2010,Service (Private),67,3,70
GOA,2010,Public Sector Undertaking,2,0,2
GOA,2010,Student,13,10,23
GOA,2010,Unemployed,51,10,61
GOA,2010,Self-employed (Business activity),11,0,11
GOA,2010,Professional Activity,1,0,1
GOA,2010,Farming/Agriculture Activity,15,0,15
GOA,2010,Others (Please Specify),18,0,18
GOA,2010,Retired Person,3,0,3
GOA,2010,Others (Please Specify),46,11,57
GOA,2010,Total,236,86,322
GOA,2010,Total Salaried,78,3,81
GOA,2010,Total Self-employed,45,0,45
GOA,2011,House Wife,0,56,56
GOA,2011,Service (Government),0,0,0
GOA,2011,Service (Private),53,8,61
GOA,2011,Public Sector Undertaking,0,0,0
GOA,2011,Student,7,20,27
GOA,2011,Unemployed,43,8,51
GOA,2011,Self-employed (Business activity),0,0,0
GOA,2011,Professional Activity,4,1,5
GOA,2011,Farming/Agriculture Activity,1,0,1
GOA,2011,Others (Please Specify),13,0,13
GOA,2011,Retired Person,4,1,5
GOA,2011,Others (Please Specify),70,4,74
GOA,2011,Total,195,98,293
GOA,2011,Total Salaried,53,8,61
GOA,2011,Total Self-employed,18,1,19
GOA,2012,House Wife,0,55,55
GOA,2012,Service (Government),9,1,10
GOA,2012,Service (Private),50,5,55
GOA,2012,Public Sector Undertaking,6,2,8
GOA,2012,Student,8,15,23
GOA,2012,Unemployed,46,3,49
GOA,2012,Self-employed (Business activity),18,0,18
GOA,2012,Professional Activity,4,0,4
GOA,2012,Farming/Agriculture Activity,1,0,1
GOA,2012,Others (Please Specify),13,2,15
GOA,2012,Retired Person,5,0,5
GOA,2012,Others (Please Specify),36,10,46
GOA,2012,Total,196,93,289
GOA,2012,Total Salaried,65,8,73
GOA,2012,Total Self-employed,36,2,38
GUJARAT,2001,House Wife,0,1568,1568
GUJARAT,2001,Service (Government),62,8,70
GUJARAT,2001,Service (Private),365,39,404
GUJARAT,2001,Public Sector Undertaking,92,15,107
GUJARAT,2001,Student,134,130,264
GUJARAT,2001,Unemployed,426,71,497
GUJARAT,2001,Self-employed (Business activity),255,1,256
GUJARAT,2001,Professional Activity,325,27,352
GUJARAT,2001,Farming/Agriculture Activity,517,77,594
GUJARAT,2001,Others (Please Specify),322,106,428
GUJARAT,2001,Retired Person,56,43,99
GUJARAT,2001,Others (Please Specify),95,57,152
GUJARAT,2001,Total,2649,2142,4791
GUJARAT,2001,Total Salaried,519,62,581
GUJARAT,2001,Total Self-employed,1419,211,1630
GUJARAT,2002,House Wife,0,1461,1461
GUJARAT,2002,Service (Government),40,3,43
GUJARAT,2002,Service (Private),317,33,350
GUJARAT,2002,Public Sector Undertaking,72,8,80
GUJARAT,2002,Student,155,114,269
GUJARAT,2002,Unemployed,467,59,526
GUJARAT,2002,Self-employed (Business activity),257,5,262
GUJARAT,2002,Professional Activity,344,19,363
GUJARAT,2002,Farming/Agriculture Activity,482,88,570
GUJARAT,2002,Others (Please Specify),350,74,424
GUJARAT,2002,Retired Person,63,33,96
GUJARAT,2002,Others (Please Specify),159,41,200
GUJARAT,2002,Total,2706,1938,4644
GUJARAT,2002,Total Salaried,429,44,473
GUJARAT,2002,Total Self-employed,1433,186,1619
GUJARAT,2003,House Wife,0,1374,1374
GUJARAT,2003,Service (Government),71,5,76
GUJARAT,2003,Service (Private),326,55,381
GUJARAT,2003,Public Sector Undertaking,37,10,47
GUJARAT,2003,Student,91,96,187
GUJARAT,2003,Unemployed,405,56,461
GUJARAT,2003,Self-employed (Business activity),225,3,228
GUJARAT,2003,Professional Activity,376,14,390
GUJARAT,2003,Farming/Agriculture Activity,469,112,581
GUJARAT,2003,Others (Please Specify),369,78,447
GUJARAT,2003,Retired Person,85,38,123
GUJARAT,2003,Others (Please Specify),196,75,271
GUJARAT,2003,Total,2650,1916,4566
GUJARAT,2003,Total Salaried,434,70,504
GUJARAT,2003,Total Self-employed,1439,207,1646
GUJARAT,2004,House Wife,0,1360,1360
GUJARAT,2004,Service (Government),60,6,66
GUJARAT,2004,Service (Private),351,69,420
GUJARAT,2004,Public Sector Undertaking,41,2,43
GUJARAT,2004,Student,140,107,247
GUJARAT,2004,Unemployed,425,52,477
GUJARAT,2004,Self-employed (Business activity),234,6,240
GUJARAT,2004,Professional Activity,365,21,386
GUJARAT,2004,Farming/Agriculture Activity,452,71,523
GUJARAT,2004,Others (Please Specify),477,119,596
GUJARAT,2004,Retired Person,61,41,102
GUJARAT,2004,Others (Please Specify),244,72,316
GUJARAT,2004,Total,2850,1926,4776
GUJARAT,2004,Total Salaried,452,77,529
GUJARAT,2004,Total Self-employed,1528,217,1745
GUJARAT,2005,House Wife,0,1320,1320
GUJARAT,2005,Service (Government),73,4,77
GUJARAT,2005,Service (Private),428,56,484
GUJARAT,2005,Public Sector Undertaking,67,3,70
GUJARAT,2005,Student,105,120,225
GUJARAT,2005,Unemployed,372,40,412
GUJARAT,2005,Self-employed (Business activity),267,2,269
GUJARAT,2005,Professional Activity,320,13,333
GUJARAT,2005,Farming/Agriculture Activity,519,96,615
GUJARAT,2005,Others (Please Specify),392,68,460
GUJARAT,2005,Retired Person,104,28,132
GUJARAT,2005,Others (Please Specify),255,113,368
GUJARAT,2005,Total,2902,1863,4765
GUJARAT,2005,Total Salaried,568,63,631
GUJARAT,2005,Total Self-employed,1498,179,1677
GUJARAT,2006,House Wife,0,1396,1396
GUJARAT,2006,Service (Government),45,9,54
GUJARAT,2006,Service (Private),461,70,531
GUJARAT,2006,Public Sector Undertaking,41,15,56
GUJARAT,2006,Student,137,103,240
GUJARAT,2006,Unemployed,410,46,456
GUJARAT,2006,Self-employed (Business activity),257,6,263
GUJARAT,2006,Professional Activity,370,29,399
GUJARAT,2006,Farming/Agriculture Activity,411,76,487
GUJARAT,2006,Others (Please Specify),477,86,563
GUJARAT,2006,Retired Person,113,57,170
GUJARAT,2006,Others (Please Specify),326,94,420
GUJARAT,2006,Total,3048,1987,5035
GUJARAT,2006,Total Salaried,547,94,641
GUJARAT,2006,Total Self-employed,1515,197,1712
GUJARAT,2007,House Wife,0,1613,1613
GUJARAT,2007,Service (Government),85,20,105
GUJARAT,2007,Service (Private),516,55,571
GUJARAT,2007,Public Sector Undertaking,140,15,155
GUJARAT,2007,Student,155,148,303
GUJARAT,2007,Unemployed,443,57,500
GUJARAT,2007,Self-employed (Business activity),270,6,276
GUJARAT,2007,Professional Activity,454,37,491
GUJARAT,2007,Farming/Agriculture Activity,289,28,317
GUJARAT,2007,Others (Please Specify),554,92,646
GUJARAT,2007,Retired Person,175,49,224
GUJARAT,2007,Others (Please Specify),294,85,379
GUJARAT,2007,Total,3375,2205,5580
GUJARAT,2007,Total Salaried,741,90,831
GUJARAT,2007,Total Self-employed,1567,163,1730
GUJARAT,2008,House Wife,0,1744,1744
GUJARAT,2008,Service (Government),57,5,62
GUJARAT,2008,Service (Private),544,64,608
GUJARAT,2008,Public Sector Undertaking,102,25,127
GUJARAT,2008,Student,155,149,304
GUJARAT,2008,Unemployed,513,45,558
GUJARAT,2008,Self-employed (Business activity),287,3,290
GUJARAT,2008,Professional Activity,420,8,428
GUJARAT,2008,Farming/Agriculture Activity,441,85,526
GUJARAT,2008,Others (Please Specify),627,110,737
GUJARAT,2008,Retired Person,142,45,187
GUJARAT,2008,Others (Please Specify),447,147,594
GUJARAT,2008,Total,3735,2430,6165
GUJARAT,2008,Total Salaried,703,94,797
GUJARAT,2008,Total Self-employed,1775,206,1981
GUJARAT,2009,House Wife,0,1736,1736
GUJARAT,2009,Service (Government),43,26,69
GUJARAT,2009,Service (Private),581,48,629
GUJARAT,2009,Public Sector Undertaking,91,24,115
GUJARAT,2009,Student,174,154,328
GUJARAT,2009,Unemployed,499,80,579
GUJARAT,2009,Self-employed (Business activity),336,2,338
GUJARAT,2009,Professional Activity,509,43,552
GUJARAT,2009,Farming/Agriculture Activity,498,90,588
GUJARAT,2009,Others (Please Specify),547,164,711
GUJARAT,2009,Retired Person,94,24,118
GUJARAT,2009,Others (Please Specify),299,94,393
GUJARAT,2009,Total,3671,2485,6156
GUJARAT,2009,Total Salaried,715,98,813
GUJARAT,2009,Total Self-employed,1890,299,2189
GUJARAT,2010,House Wife,0,1575,1575
GUJARAT,2010,Service (Government),62,13,75
GUJARAT,2010,Service (Private),524,98,622
GUJARAT,2010,Public Sector Undertaking,77,24,101
GUJARAT,2010,Student,151,142,293
GUJARAT,2010,Unemployed,548,61,609
GUJARAT,2010,Self-employed (Business activity),428,39,467
GUJARAT,2010,Professional Activity,321,19,340
GUJARAT,2010,Farming/Agriculture Activity,458,65,523
GUJARAT,2010,Others (Please Specify),599,130,729
GUJARAT,2010,Retired Person,99,52,151
GUJARAT,2010,Others (Please Specify),546,176,722
GUJARAT,2010,Total,3813,2394,6207
GUJARAT,2010,Total Salaried,663,135,798
GUJARAT,2010,Total Self-employed,1806,253,2059
GUJARAT,2011,House Wife,0,1571,1571
GUJARAT,2011,Service (Government),60,14,74
GUJARAT,2011,Service (Private),581,92,673
GUJARAT,2011,Public Sector Undertaking,98,26,124
GUJARAT,2011,Student,178,148,326
GUJARAT,2011,Unemployed,443,48,491
GUJARAT,2011,Self-employed (Business activity),312,1,313
GUJARAT,2011,Professional Activity,531,61,592
GUJARAT,2011,Farming/Agriculture Activity,473,105,578
GUJARAT,2011,Others (Please Specify),653,158,811
GUJARAT,2011,Retired Person,103,54,157
GUJARAT,2011,Others (Please Specify),480,192,672
GUJARAT,2011,Total,3912,2470,6382
GUJARAT,2011,Total Salaried,739,132,871
GUJARAT,2011,Total Self-employed,1969,325,2294
GUJARAT,2012,House Wife,0,1795,1795
GUJARAT,2012,Service (Government),75,16,91
GUJARAT,2012,Service (Private),758,137,895
GUJARAT,2012,Public Sector Undertaking,115,35,150
GUJARAT,2012,Student,215,173,388
GUJARAT,2012,Unemployed,511,46,557
GUJARAT,2012,Self-employed (Business activity),265,4,269
GUJARAT,2012,Professional Activity,478,32,510
GUJARAT,2012,Farming/Agriculture Activity,472,92,564
GUJARAT,2012,Others (Please Specify),737,154,891
GUJARAT,2012,Retired Person,139,47,186
GUJARAT,2012,Others (Please Specify),597,217,814
GUJARAT,2012,Total,4362,2748,7110
GUJARAT,2012,Total Salaried,948,188,1136
GUJARAT,2012,Total Self-employed,1952,282,2234
HARYANA,2001,House Wife,0,297,297
HARYANA,2001,Service (Government),73,21,94
HARYANA,2001,Service (Private),98,47,145
HARYANA,2001,Public Sector Undertaking,66,28,94
HARYANA,2001,Student,87,41,128
HARYANA,2001,Unemployed,227,60,287
HARYANA,2001,Self-employed (Business activity),57,0,57
HARYANA,2001,Professional Activity,64,1,65
HARYANA,2001,Farming/Agriculture Activity,133,12,145
HARYANA,2001,Others (Please Specify),103,28,131
HARYANA,2001,Retired Person,18,4,22
HARYANA,2001,Others (Please Specify),438,104,542
HARYANA,2001,Total,1364,643,2007
HARYANA,2001,Total Salaried,237,96,333
HARYANA,2001,Total Self-employed,357,41,398
HARYANA,2002,House Wife,0,371,371
HARYANA,2002,Service (Government),66,31,97
HARYANA,2002,Service (Private),208,35,243
HARYANA,2002,Public Sector Undertaking,65,14,79
HARYANA,2002,Student,99,58,157
HARYANA,2002,Unemployed,194,11,205
HARYANA,2002,Self-employed (Business activity),39,0,39
HARYANA,2002,Professional Activity,32,1,33
HARYANA,2002,Farming/Agriculture Activity,167,23,190
HARYANA,2002,Others (Please Specify),219,11,230
HARYANA,2002,Retired Person,8,9,17
HARYANA,2002,Others (Please Specify),473,66,539
HARYANA,2002,Total,1570,630,2200
HARYANA,2002,Total Salaried,339,80,419
HARYANA,2002,Total Self-employed,457,35,492
HARYANA,2003,House Wife,0,321,321
HARYANA,2003,Service (Government),68,10,78
HARYANA,2003,Service (Private),190,36,226
HARYANA,2003,Public Sector Undertaking,54,17,71
HARYANA,2003,Student,86,39,125
HARYANA,2003,Unemployed,184,28,212
HARYANA,2003,Self-employed (Business activity),135,1,136
HARYANA,2003,Professional Activity,33,0,33
HARYANA,2003,Farming/Agriculture Activity,192,15,207
HARYANA,2003,Others (Please Specify),187,73,260
HARYANA,2003,Retired Person,23,7,30
HARYANA,2003,Others (Please Specify),461,67,528
HARYANA,2003,Total,1613,614,2227
HARYANA,2003,Total Salaried,312,63,375
HARYANA,2003,Total Self-employed,547,89,636
HARYANA,2004,House Wife,0,330,330
HARYANA,2004,Service (Government),67,16,83
HARYANA,2004,Service (Private),172,37,209
HARYANA,2004,Public Sector Undertaking,50,10,60
HARYANA,2004,Student,79,38,117
HARYANA,2004,Unemployed,187,24,211
HARYANA,2004,Self-employed (Business activity),89,0,89
HARYANA,2004,Professional Activity,33,0,33
HARYANA,2004,Farming/Agriculture Activity,144,16,160
HARYANA,2004,Others (Please Specify),176,40,216
HARYANA,2004,Retired Person,9,0,9
HARYANA,2004,Others (Please Specify),448,117,565
HARYANA,2004,Total,1454,628,2082
HARYANA,2004,Total Salaried,289,63,352
HARYANA,2004,Total Self-employed,442,56,498
HARYANA,2005,House Wife,0,303,303
HARYANA,2005,Service (Government),37,6,43
HARYANA,2005,Service (Private),144,11,155
HARYANA,2005,Public Sector Undertaking,15,5,20
HARYANA,2005,Student,67,34,101
HARYANA,2005,Unemployed,146,13,159
HARYANA,2005,Self-employed (Business activity),71,0,71
HARYANA,2005,Professional Activity,18,1,19
HARYANA,2005,Farming/Agriculture Activity,128,12,140
HARYANA,2005,Others (Please Specify),202,19,221
HARYANA,2005,Retired Person,11,5,16
HARYANA,2005,Others (Please Specify),654,144,798
HARYANA,2005,Total,1493,553,2046
HARYANA,2005,Total Salaried,196,22,218
HARYANA,2005,Total Self-employed,419,32,451
HARYANA,2006,House Wife,0,319,319
HARYANA,2006,Service (Government),49,10,59
HARYANA,2006,Service (Private),321,54,375
HARYANA,2006,Public Sector Undertaking,78,21,99
HARYANA,2006,Student,86,40,126
HARYANA,2006,Unemployed,243,15,258
HARYANA,2006,Self-employed (Business activity),89,12,101
HARYANA,2006,Professional Activity,24,2,26
HARYANA,2006,Farming/Agriculture Activity,181,9,190
HARYANA,2006,Others (Please Specify),218,15,233
HARYANA,2006,Retired Person,54,1,55
HARYANA,2006,Others (Please Specify),423,52,475
HARYANA,2006,Total,1766,550,2316
HARYANA,2006,Total Salaried,448,85,533
HARYANA,2006,Total Self-employed,512,38,550
HARYANA,2007,House Wife,0,356,356
HARYANA,2007,Service (Government),64,15,79
HARYANA,2007,Service (Private),224,22,246
HARYANA,2007,Public Sector Undertaking,75,12,87
HARYANA,2007,Student,80,42,122
HARYANA,2007,Unemployed,259,23,282
HARYANA,2007,Self-employed (Business activity),86,2,88
HARYANA,2007,Professional Activity,57,0,57
HARYANA,2007,Farming/Agriculture Activity,179,0,179
HARYANA,2007,Others (Please Specify),121,42,163
HARYANA,2007,Retired Person,73,2,75
HARYANA,2007,Others (Please Specify),634,65,699
HARYANA,2007,Total,1852,581,2433
HARYANA,2007,Total Salaried,363,49,412
HARYANA,2007,Total Self-employed,443,44,487
HARYANA,2008,House Wife,0,366,366
HARYANA,2008,Service (Government),90,3,93
HARYANA,2008,Service (Private),239,11,250
HARYANA,2008,Public Sector Undertaking,92,4,96
HARYANA,2008,Student,92,43,135
HARYANA,2008,Unemployed,159,24,183
HARYANA,2008,Self-employed (Business activity),38,3,41
HARYANA,2008,Professional Activity,50,0,50
HARYANA,2008,Farming/Agriculture Activity,150,0,150
HARYANA,2008,Others (Please Specify),123,21,144
HARYANA,2008,Retired Person,8,4,12
HARYANA,2008,Others (Please Specify),933,203,1136
HARYANA,2008,Total,1974,682,2656
HARYANA,2008,Total Salaried,421,18,439
HARYANA,2008,Total Self-employed,361,24,385
HARYANA,2009,House Wife,0,441,441
HARYANA,2009,Service (Government),80,6,86
HARYANA,2009,Service (Private),253,32,285
HARYANA,2009,Public Sector Undertaking,64,7,71
HARYANA,2009,Student,83,32,115
HARYANA,2009,Unemployed,220,33,253
HARYANA,2009,Self-employed (Business activity),49,0,49
HARYANA,2009,Professional Activity,28,0,28
HARYANA,2009,Farming/Agriculture Activity,225,5,230
HARYANA,2009,Others (Please Specify),164,4,168
HARYANA,2009,Retired Person,0,0,0
HARYANA,2009,Others (Please Specify),649,128,777
HARYANA,2009,Total,1815,688,2503
HARYANA,2009,Total Salaried,397,45,442
HARYANA,2009,Total Self-employed,466,9,475
HARYANA,2010,House Wife,0,364,364
HARYANA,2010,Service (Government),40,45,85
HARYANA,2010,Service (Private),194,27,221
HARYANA,2010,Public Sector Undertaking,11,5,16
HARYANA,2010,Student,119,29,148
HARYANA,2010,Unemployed,347,37,384
HARYANA,2010,Self-employed (Business activity),46,0,46
HARYANA,2010,Professional Activity,45,0,45
HARYANA,2010,Farming/Agriculture Activity,281,16,297
HARYANA,2010,Others (Please Specify),553,50,603
HARYANA,2010,Retired Person,0,0,0
HARYANA,2010,Others (Please Specify),542,144,686
HARYANA,2010,Total,2178,717,2895
HARYANA,2010,Total Salaried,245,77,322
HARYANA,2010,Total Self-employed,925,66,991
HARYANA,2011,House Wife,0,416,416
HARYANA,2011,Service (Government),72,7,79
HARYANA,2011,Service (Private),193,20,213
HARYANA,2011,Public Sector Undertaking,20,5,25
HARYANA,2011,Student,129,51,180
HARYANA,2011,Unemployed,332,44,376
HARYANA,2011,Self-employed (Business activity),62,0,62
HARYANA,2011,Professional Activity,24,0,24
HARYANA,2011,Farming/Agriculture Activity,350,34,384
HARYANA,2011,Others (Please Specify),242,18,260
HARYANA,2011,Retired Person,2,0,2
HARYANA,2011,Others (Please Specify),1038,186,1224
HARYANA,2011,Total,2464,781,3245
HARYANA,2011,Total Salaried,285,32,317
HARYANA,2011,Total Self-employed,678,52,730
HARYANA,2012,House Wife,0,389,389
HARYANA,2012,Service (Government),48,3,51
HARYANA,2012,Service (Private),235,12,247
HARYANA,2012,Public Sector Undertaking,52,5,57
HARYANA,2012,Student,109,33,142
HARYANA,2012,Unemployed,293,34,327
HARYANA,2012,Self-employed (Business activity),45,0,45
HARYANA,2012,Professional Activity,41,0,41
HARYANA,2012,Farming/Agriculture Activity,251,25,276
HARYANA,2012,Others (Please Specify),626,137,763
HARYANA,2012,Retired Person,3,0,3
HARYANA,2012,Others (Please Specify),368,118,486
HARYANA,2012,Total,2071,756,2827
HARYANA,2012,Total Salaried,335,20,355
HARYANA,2012,Total Self-employed,963,162,1125
HIMACHAL PRADESH,2001,House Wife,0,84,84
HIMACHAL PRADESH,2001,Service (Government),8,3,11
HIMACHAL PRADESH,2001,Service (Private),24,0,24
HIMACHAL PRADESH,2001,Public Sector Undertaking,7,0,7
HIMACHAL PRADESH,2001,Student,8,11,19
HIMACHAL PRADESH,2001,Unemployed,31,7,38
HIMACHAL PRADESH,2001,Self-employed (Business activity),9,0,9
HIMACHAL PRADESH,2001,Professional Activity,2,1,3
HIMACHAL PRADESH,2001,Farming/Agriculture Activity,22,0,22
HIMACHAL PRADESH,2001,Others (Please Specify),13,6,19
HIMACHAL PRADESH,2001,Retired Person,1,0,1
HIMACHAL PRADESH,2001,Others (Please Specify),52,18,70
HIMACHAL PRADESH,2001,Total,177,130,307
HIMACHAL PRADESH,2001,Total Salaried,39,3,42
HIMACHAL PRADESH,2001,Total Self-employed,46,7,53
HIMACHAL PRADESH,2002,House Wife,0,83,83
HIMACHAL PRADESH,2002,Service (Government),11,2,13
HIMACHAL PRADESH,2002,Service (Private),12,0,12
HIMACHAL PRADESH,2002,Public Sector Undertaking,4,1,5
HIMACHAL PRADESH,2002,Student,19,12,31
HIMACHAL PRADESH,2002,Unemployed,25,4,29
HIMACHAL PRADESH,2002,Self-employed (Business activity),29,1,30
HIMACHAL PRADESH,2002,Professional Activity,12,1,13
HIMACHAL PRADESH,2002,Farming/Agriculture Activity,24,1,25
HIMACHAL PRADESH,2002,Others (Please Specify),18,1,19
HIMACHAL PRADESH,2002,Retired Person,0,0,0
HIMACHAL PRADESH,2002,Others (Please Specify),54,20,74
HIMACHAL PRADESH,2002,Total,208,126,334
HIMACHAL PRADESH,2002,Total Salaried,27,3,30
HIMACHAL PRADESH,2002,Total Self-employed,83,4,87
HIMACHAL PRADESH,2003,House Wife,0,72,72
HIMACHAL PRADESH,2003,Service (Government),14,2,16
HIMACHAL PRADESH,2003,Service (Private),30,2,32
HIMACHAL PRADESH,2003,Public Sector Undertaking,2,0,2
HIMACHAL PRADESH,2003,Student,11,19,30
HIMACHAL PRADESH,2003,Unemployed,41,1,42
HIMACHAL PRADESH,2003,Self-employed (Business activity),13,0,13
HIMACHAL PRADESH,2003,Professional Activity,2,0,2
HIMACHAL PRADESH,2003,Farming/Agriculture Activity,29,5,34
HIMACHAL PRADESH,2003,Others (Please Specify),42,6,48
HIMACHAL PRADESH,2003,Retired Person,1,0,1
HIMACHAL PRADESH,2003,Others (Please Specify),55,39,94
HIMACHAL PRADESH,2003,Total,240,146,386
HIMACHAL PRADESH,2003,Total Salaried,46,4,50
HIMACHAL PRADESH,2003,Total Self-employed,86,11,97
HIMACHAL PRADESH,2004,House Wife,0,75,75
HIMACHAL PRADESH,2004,Service (Government),13,1,14
HIMACHAL PRADESH,2004,Service (Private),49,2,51
HIMACHAL PRADESH,2004,Public Sector Undertaking,2,0,2
HIMACHAL PRADESH,2004,Student,11,12,23
HIMACHAL PRADESH,2004,Unemployed,34,12,46
HIMACHAL PRADESH,2004,Self-employed (Business activity),11,1,12
HIMACHAL PRADESH,2004,Professional Activity,1,0,1
HIMACHAL PRADESH,2004,Farming/Agriculture Activity,43,9,52
HIMACHAL PRADESH,2004,Others (Please Specify),29,10,39
HIMACHAL PRADESH,2004,Retired Person,0,0,0
HIMACHAL PRADESH,2004,Others (Please Specify),43,13,56
HIMACHAL PRADESH,2004,Total,236,135,371
HIMACHAL PRADESH,2004,Total Salaried,64,3,67
HIMACHAL PRADESH,2004,Total Self-employed,84,20,104
HIMACHAL PRADESH,2005,House Wife,0,75,75
HIMACHAL PRADESH,2005,Service (Government),14,2,16
HIMACHAL PRADESH,2005,Service (Private),29,0,29
HIMACHAL PRADESH,2005,Public Sector Undertaking,7,1,8
HIMACHAL PRADESH,2005,Student,10,15,25
HIMACHAL PRADESH,2005,Unemployed,19,8,27
HIMACHAL PRADESH,2005,Self-employed (Business activity),7,0,7
HIMACHAL PRADESH,2005,Professional Activity,4,0,4
HIMACHAL PRADESH,2005,Farming/Agriculture Activity,20,0,20
HIMACHAL PRADESH,2005,Others (Please Specify),64,15,79
HIMACHAL PRADESH,2005,Retired Person,0,0,0
HIMACHAL PRADESH,2005,Others (Please Specify),40,29,69
HIMACHAL PRADESH,2005,Total,214,145,359
HIMACHAL PRADESH,2005,Total Salaried,50,3,53
HIMACHAL PRADESH,2005,Total Self-employed,95,15,110
HIMACHAL PRADESH,2006,House Wife,0,78,78
HIMACHAL PRADESH,2006,Service (Government),21,1,22
HIMACHAL PRADESH,2006,Service (Private),47,10,57
HIMACHAL PRADESH,2006,Public Sector Undertaking,40,1,41
HIMACHAL PRADESH,2006,Student,20,20,40
HIMACHAL PRADESH,2006,Unemployed,32,0,32
HIMACHAL PRADESH,2006,Self-employed (Business activity),17,0,17
HIMACHAL PRADESH,2006,Professional Activity,4,0,4
HIMACHAL PRADESH,2006,Farming/Agriculture Activity,22,0,22
HIMACHAL PRADESH,2006,Others (Please Specify),2,0,2
HIMACHAL PRADESH,2006,Retired Person,1,0,1
HIMACHAL PRADESH,2006,Others (Please Specify),95,46,141
HIMACHAL PRADESH,2006,Total,301,156,457
HIMACHAL PRADESH,2006,Total Salaried,108,12,120
HIMACHAL PRADESH,2006,Total Self-employed,45,0,45
HIMACHAL PRADESH,2007,House Wife,0,56,56
HIMACHAL PRADESH,2007,Service (Government),11,0,11
HIMACHAL PRADESH,2007,Service (Private),46,4,50
HIMACHAL PRADESH,2007,Public Sector Undertaking,12,3,15
HIMACHAL PRADESH,2007,Student,13,22,35
HIMACHAL PRADESH,2007,Unemployed,23,4,27
HIMACHAL PRADESH,2007,Self-employed (Business activity),25,3,28
HIMACHAL PRADESH,2007,Professional Activity,8,2,10
HIMACHAL PRADESH,2007,Farming/Agriculture Activity,14,1,15
HIMACHAL PRADESH,2007,Others (Please Specify),66,23,89
HIMACHAL PRADESH,2007,Retired Person,1,0,1
HIMACHAL PRADESH,2007,Others (Please Specify),39,26,65
HIMACHAL PRADESH,2007,Total,258,144,402
HIMACHAL PRADESH,2007,Total Salaried,69,7,76
HIMACHAL PRADESH,2007,Total Self-employed,113,29,142
HIMACHAL PRADESH,2008,House Wife,0,87,87
HIMACHAL PRADESH,2008,Service (Government),19,2,21
HIMACHAL PRADESH,2008,Service (Private),39,10,49
HIMACHAL PRADESH,2008,Public Sector Undertaking,16,7,23
HIMACHAL PRADESH,2008,Student,20,16,36
HIMACHAL PRADESH,2008,Unemployed,29,9,38
HIMACHAL PRADESH,2008,Self-employed (Business activity),31,1,32
HIMACHAL PRADESH,2008,Professional Activity,9,5,14
HIMACHAL PRADESH,2008,Farming/Agriculture Activity,150,38,188
HIMACHAL PRADESH,2008,Others (Please Specify),66,18,84
HIMACHAL PRADESH,2008,Retired Person,3,0,3
HIMACHAL PRADESH,2008,Others (Please Specify),35,20,55
HIMACHAL PRADESH,2008,Total,417,213,630
HIMACHAL PRADESH,2008,Total Salaried,74,19,93
HIMACHAL PRADESH,2008,Total Self-employed,256,62,318
HIMACHAL PRADESH,2009,House Wife,0,94,94
HIMACHAL PRADESH,2009,Service (Government),26,6,32
HIMACHAL PRADESH,2009,Service (Private),35,7,42
HIMACHAL PRADESH,2009,Public Sector Undertaking,18,6,24
HIMACHAL PRADESH,2009,Student,25,25,50
HIMACHAL PRADESH,2009,Unemployed,52,12,64
HIMACHAL PRADESH,2009,Self-employed (Business activity),16,1,17
HIMACHAL PRADESH,2009,Professional Activity,3,0,3
HIMACHAL PRADESH,2009,Farming/Agriculture Activity,24,0,24
HIMACHAL PRADESH,2009,Others (Please Specify),36,7,43
HIMACHAL PRADESH,2009,Retired Person,4,1,5
HIMACHAL PRADESH,2009,Others (Please Specify),127,35,162
HIMACHAL PRADESH,2009,Total,366,194,560
HIMACHAL PRADESH,2009,Total Salaried,79,19,98
HIMACHAL PRADESH,2009,Total Self-employed,79,8,87
HIMACHAL PRADESH,2010,House Wife,0,88,88
HIMACHAL PRADESH,2010,Service (Government),20,3,23
HIMACHAL PRADESH,2010,Service (Private),38,7,45
HIMACHAL PRADESH,2010,Public Sector Undertaking,12,6,18
HIMACHAL PRADESH,2010,Student,33,33,66
HIMACHAL PRADESH,2010,Unemployed,52,3,55
HIMACHAL PRADESH,2010,Self-employed (Business activity),19,5,24
HIMACHAL PRADESH,2010,Professional Activity,21,1,22
HIMACHAL PRADESH,2010,Farming/Agriculture Activity,59,2,61
HIMACHAL PRADESH,2010,Others (Please Specify),37,22,59
HIMACHAL PRADESH,2010,Retired Person,7,0,7
HIMACHAL PRADESH,2010,Others (Please Specify),50,24,74
HIMACHAL PRADESH,2010,Total,348,194,542
HIMACHAL PRADESH,2010,Total Salaried,70,16,86
HIMACHAL PRADESH,2010,Total Self-employed,136,30,166
HIMACHAL PRADESH,2011,House Wife,0,65,65
HIMACHAL PRADESH,2011,Service (Government),10,3,13
HIMACHAL PRADESH,2011,Service (Private),41,5,46
HIMACHAL PRADESH,2011,Public Sector Undertaking,21,7,28
HIMACHAL PRADESH,2011,Student,22,24,46
HIMACHAL PRADESH,2011,Unemployed,17,6,23
HIMACHAL PRADESH,2011,Self-employed (Business activity),19,5,24
HIMACHAL PRADESH,2011,Professional Activity,5,2,7
HIMACHAL PRADESH,2011,Farming/Agriculture Activity,42,4,46
HIMACHAL PRADESH,2011,Others (Please Specify),35,21,56
HIMACHAL PRADESH,2011,Retired Person,0,0,0
HIMACHAL PRADESH,2011,Others (Please Specify),57,32,89
HIMACHAL PRADESH,2011,Total,269,174,443
HIMACHAL PRADESH,2011,Total Salaried,72,15,87
HIMACHAL PRADESH,2011,Total Self-employed,101,32,133
HIMACHAL PRADESH,2012,House Wife,0,80,80
HIMACHAL PRADESH,2012,Service (Government),6,4,10
HIMACHAL PRADESH,2012,Service (Private),32,7,39
HIMACHAL PRADESH,2012,Public Sector Undertaking,20,8,28
HIMACHAL PRADESH,2012,Student,29,18,47
HIMACHAL PRADESH,2012,Unemployed,40,4,44
HIMACHAL PRADESH,2012,Self-employed (Business activity),32,4,36
HIMACHAL PRADESH,2012,Professional Activity,6,2,8
HIMACHAL PRADESH,2012,Farming/Agriculture Activity,27,2,29
HIMACHAL PRADESH,2012,Others (Please Specify),37,12,49
HIMACHAL PRADESH,2012,Retired Person,3,0,3
HIMACHAL PRADESH,2012,Others (Please Specify),122,33,155
HIMACHAL PRADESH,2012,Total,354,174,528
HIMACHAL PRADESH,2012,Total Salaried,58,19,77
HIMACHAL PRADESH,2012,Total Self-employed,102,20,122
JAMMU & KASHMIR,2001,House Wife,0,36,36
JAMMU & KASHMIR,2001,Service (Government),9,0,9
JAMMU & KASHMIR,2001,Service (Private),2,0,2
JAMMU & KASHMIR,2001,Public Sector Undertaking,1,0,1
JAMMU & KASHMIR,2001,Student,5,1,6
JAMMU & KASHMIR,2001,Unemployed,12,3,15
JAMMU & KASHMIR,2001,Self-employed (Business activity),2,0,2
JAMMU & KASHMIR,2001,Professional Activity,2,0,2
JAMMU & KASHMIR,2001,Farming/Agriculture Activity,12,3,15
JAMMU & KASHMIR,2001,Others (Please Specify),8,4,12
JAMMU & KASHMIR,2001,Retired Person,0,0,0
JAMMU & KASHMIR,2001,Others (Please Specify),38,15,53
JAMMU & KASHMIR,2001,Total,91,62,153
JAMMU & KASHMIR,2001,Total Salaried,12,0,12
JAMMU & KASHMIR,2001,Total Self-employed,24,7,31
JAMMU & KASHMIR,2002,House Wife,0,53,53
JAMMU & KASHMIR,2002,Service (Government),11,0,11
JAMMU & KASHMIR,2002,Service (Private),8,0,8
JAMMU & KASHMIR,2002,Public Sector Undertaking,2,0,2
JAMMU & KASHMIR,2002,Student,8,4,12
JAMMU & KASHMIR,2002,Unemployed,16,4,20
JAMMU & KASHMIR,2002,Self-employed (Business activity),0,0,0
JAMMU & KASHMIR,2002,Professional Activity,0,0,0
JAMMU & KASHMIR,2002,Farming/Agriculture Activity,15,1,16
JAMMU & KASHMIR,2002,Others (Please Specify),24,17,41
JAMMU & KASHMIR,2002,Retired Person,0,0,0
JAMMU & KASHMIR,2002,Others (Please Specify),12,9,21
JAMMU & KASHMIR,2002,Total,96,88,184
JAMMU & KASHMIR,2002,Total Salaried,21,0,21
JAMMU & KASHMIR,2002,Total Self-employed,39,18,57
JAMMU & KASHMIR,2003,House Wife,0,41,41
JAMMU & KASHMIR,2003,Service (Government),5,0,5
JAMMU & KASHMIR,2003,Service (Private),0,0,0
JAMMU & KASHMIR,2003,Public Sector Undertaking,0,0,0
JAMMU & KASHMIR,2003,Student,2,2,4
JAMMU & KASHMIR,2003,Unemployed,4,0,4
JAMMU & KASHMIR,2003,Self-employed (Business activity),0,0,0
JAMMU & KASHMIR,2003,Professional Activity,0,0,0
JAMMU & KASHMIR,2003,Farming/Agriculture Activity,5,3,8
JAMMU & KASHMIR,2003,Others (Please Specify),5,2,7
JAMMU & KASHMIR,2003,Retired Person,0,0,0
JAMMU & KASHMIR,2003,Others (Please Specify),42,27,69
JAMMU & KASHMIR,2003,Total,63,75,138
JAMMU & KASHMIR,2003,Total Salaried,5,0,5
JAMMU & KASHMIR,2003,Total Self-employed,10,5,15
JAMMU & KASHMIR,2004,House Wife,0,29,29
JAMMU & KASHMIR,2004,Service (Government),4,0,4
JAMMU & KASHMIR,2004,Service (Private),0,0,0
JAMMU & KASHMIR,2004,Public Sector Undertaking,0,1,1
JAMMU & KASHMIR,2004,Student,3,3,6
JAMMU & KASHMIR,2004,Unemployed,6,0,6
JAMMU & KASHMIR,2004,Self-employed (Business activity),0,0,0
JAMMU & KASHMIR,2004,Professional Activity,0,0,0
JAMMU & KASHMIR,2004,Farming/Agriculture Activity,1,0,1
JAMMU & KASHMIR,2004,Others (Please Specify),5,10,15
JAMMU & KASHMIR,2004,Retired Person,0,0,0
JAMMU & KASHMIR,2004,Others (Please Specify),32,18,50
JAMMU & KASHMIR,2004,Total,51,61,112
JAMMU & KASHMIR,2004,Total Salaried,4,1,5
JAMMU & KASHMIR,2004,Total Self-employed,6,10,16
JAMMU & KASHMIR,2005,House Wife,0,32,32
JAMMU & KASHMIR,2005,Service (Government),18,0,18
JAMMU & KASHMIR,2005,Service (Private),34,0,34
JAMMU & KASHMIR,2005,Public Sector Undertaking,0,0,0
JAMMU & KASHMIR,2005,Student,20,4,24
JAMMU & KASHMIR,2005,Unemployed,27,13,40
JAMMU & KASHMIR,2005,Self-employed (Business activity),0,0,0
JAMMU & KASHMIR,2005,Professional Activity,0,0,0
JAMMU & KASHMIR,2005,Farming/Agriculture Activity,1,1,2
JAMMU & KASHMIR,2005,Others (Please Specify),33,28,61
JAMMU & KASHMIR,2005,Retired Person,7,0,7
JAMMU & KASHMIR,2005,Others (Please Specify),56,20,76
JAMMU & KASHMIR,2005,Total,196,98,294
JAMMU & KASHMIR,2005,Total Salaried,52,0,52
JAMMU & KASHMIR,2005,Total Self-employed,34,29,63
JAMMU & KASHMIR,2006,House Wife,0,42,42
JAMMU & KASHMIR,2006,Service (Government),24,3,27
JAMMU & KASHMIR,2006,Service (Private),8,4,12
JAMMU & KASHMIR,2006,Public Sector Undertaking,2,0,2
JAMMU & KASHMIR,2006,Student,7,15,22
JAMMU & KASHMIR,2006,Unemployed,26,8,34
JAMMU & KASHMIR,2006,Self-employed (Business activity),2,0,2
JAMMU & KASHMIR,2006,Professional Activity,0,5,5
JAMMU & KASHMIR,2006,Farming/Agriculture Activity,30,4,34
JAMMU & KASHMIR,2006,Others (Please Specify),20,17,37
JAMMU & KASHMIR,2006,Retired Person,2,0,2
JAMMU & KASHMIR,2006,Others (Please Specify),31,12,43
JAMMU & KASHMIR,2006,Total,152,110,262
JAMMU & KASHMIR,2006,Total Salaried,34,7,41
JAMMU & KASHMIR,2006,Total Self-employed,52,26,78
JAMMU & KASHMIR,2007,House Wife,0,53,53
JAMMU & KASHMIR,2007,Service (Government),12,2,14
JAMMU & KASHMIR,2007,Service (Private),10,1,11
JAMMU & KASHMIR,2007,Public Sector Undertaking,5,2,7
JAMMU & KASHMIR,2007,Student,14,10,24
JAMMU & KASHMIR,2007,Unemployed,25,3,28
JAMMU & KASHMIR,2007,Self-employed (Business activity),3,0,3
JAMMU & KASHMIR,2007,Professional Activity,3,0,3
JAMMU & KASHMIR,2007,Farming/Agriculture Activity,31,2,33
JAMMU & KASHMIR,2007,Others (Please Specify),16,1,17
JAMMU & KASHMIR,2007,Retired Person,4,0,4
JAMMU & KASHMIR,2007,Others (Please Specify),30,7,37
JAMMU & KASHMIR,2007,Total,153,81,234
JAMMU & KASHMIR,2007,Total Salaried,27,5,32
JAMMU & KASHMIR,2007,Total Self-employed,53,3,56
JAMMU & KASHMIR,2008,House Wife,0,75,75
JAMMU & KASHMIR,2008,Service (Government),25,3,28
JAMMU & KASHMIR,2008,Service (Private),22,5,27
JAMMU & KASHMIR,2008,Public Sector Undertaking,20,1,21
JAMMU & KASHMIR,2008,Student,7,9,16
JAMMU & KASHMIR,2008,Unemployed,37,14,51
JAMMU & KASHMIR,2008,Self-employed (Business activity),6,0,6
JAMMU & KASHMIR,2008,Professional Activity,4,0,4
JAMMU & KASHMIR,2008,Farming/Agriculture Activity,4,2,6
JAMMU & KASHMIR,2008,Others (Please Specify),23,12,35
JAMMU & KASHMIR,2008,Retired Person,6,0,6
JAMMU & KASHMIR,2008,Others (Please Specify),23,12,35
JAMMU & KASHMIR,2008,Total,177,133,310
JAMMU & KASHMIR,2008,Total Salaried,67,9,76
JAMMU & KASHMIR,2008,Total Self-employed,37,14,51
JAMMU & KASHMIR,2009,House Wife,0,50,50
JAMMU & KASHMIR,2009,Service (Government),26,9,35
JAMMU & KASHMIR,2009,Service (Private),24,6,30
JAMMU & KASHMIR,2009,Public Sector Undertaking,6,1,7
JAMMU & KASHMIR,2009,Student,4,16,20
JAMMU & KASHMIR,2009,Unemployed,41,21,62
JAMMU & KASHMIR,2009,Self-employed (Business activity),17,1,18
JAMMU & KASHMIR,2009,Professional Activity,2,1,3
JAMMU & KASHMIR,2009,Farming/Agriculture Activity,8,0,8
JAMMU & KASHMIR,2009,Others (Please Specify),21,19,40
JAMMU & KASHMIR,2009,Retired Person,0,0,0
JAMMU & KASHMIR,2009,Others (Please Specify),19,29,48
JAMMU & KASHMIR,2009,Total,168,153,321
JAMMU & KASHMIR,2009,Total Salaried,56,16,72
JAMMU & KASHMIR,2009,Total Self-employed,48,21,69
JAMMU & KASHMIR,2010,House Wife,0,58,58
JAMMU & KASHMIR,2010,Service (Government),4,2,6
JAMMU & KASHMIR,2010,Service (Private),13,0,13
JAMMU & KASHMIR,2010,Public Sector Undertaking,2,0,2
JAMMU & KASHMIR,2010,Student,17,19,36
JAMMU & KASHMIR,2010,Unemployed,27,16,43
JAMMU & KASHMIR,2010,Self-employed (Business activity),9,0,9
JAMMU & KASHMIR,2010,Professional Activity,2,1,3
JAMMU & KASHMIR,2010,Farming/Agriculture Activity,16,2,18
JAMMU & KASHMIR,2010,Others (Please Specify),12,9,21
JAMMU & KASHMIR,2010,Retired Person,1,0,1
JAMMU & KASHMIR,2010,Others (Please Specify),19,30,49
JAMMU & KASHMIR,2010,Total,122,137,259
JAMMU & KASHMIR,2010,Total Salaried,19,2,21
JAMMU & KASHMIR,2010,Total Self-employed,39,12,51
JAMMU & KASHMIR,2011,House Wife,0,58,58
JAMMU & KASHMIR,2011,Service (Government),9,4,13
JAMMU & KASHMIR,2011,Service (Private),9,2,11
JAMMU & KASHMIR,2011,Public Sector Undertaking,4,0,4
JAMMU & KASHMIR,2011,Student,13,27,40
JAMMU & KASHMIR,2011,Unemployed,18,18,36
JAMMU & KASHMIR,2011,Self-employed (Business activity),13,2,15
JAMMU & KASHMIR,2011,Professional Activity,7,0,7
JAMMU & KASHMIR,2011,Farming/Agriculture Activity,11,3,14
JAMMU & KASHMIR,2011,Others (Please Specify),19,16,35
JAMMU & KASHMIR,2011,Retired Person,4,0,4
JAMMU & KASHMIR,2011,Others (Please Specify),37,13,50
JAMMU & KASHMIR,2011,Total,144,143,287
JAMMU & KASHMIR,2011,Total Salaried,22,6,28
JAMMU & KASHMIR,2011,Total Self-employed,50,21,71
JAMMU & KASHMIR,2012,House Wife,0,75,75
JAMMU & KASHMIR,2012,Service (Government),21,3,24
JAMMU & KASHMIR,2012,Service (Private),5,13,18
JAMMU & KASHMIR,2012,Public Sector Undertaking,0,0,0
JAMMU & KASHMIR,2012,Student,20,42,62
JAMMU & KASHMIR,2012,Unemployed,33,20,53
JAMMU & KASHMIR,2012,Self-employed (Business activity),10,0,10
JAMMU & KASHMIR,2012,Professional Activity,7,4,11
JAMMU & KASHMIR,2012,Farming/Agriculture Activity,10,0,10
JAMMU & KASHMIR,2012,Others (Please Specify),12,19,31
JAMMU & KASHMIR,2012,Retired Person,5,0,5
JAMMU & KASHMIR,2012,Others (Please Specify),69,46,115
JAMMU & KASHMIR,2012,Total,192,222,414
JAMMU & KASHMIR,2012,Total Salaried,26,16,42
JAMMU & KASHMIR,2012,Total Self-employed,39,23,62
JHARKHAND,2001,House Wife,0,59,59
JHARKHAND,2001,Service (Government),0,0,0
JHARKHAND,2001,Service (Private),4,2,6
JHARKHAND,2001,Public Sector Undertaking,3,2,5
JHARKHAND,2001,Student,6,1,7
JHARKHAND,2001,Unemployed,18,1,19
JHARKHAND,2001,Self-employed (Business activity),1,0,1
JHARKHAND,2001,Professional Activity,6,0,6
JHARKHAND,2001,Farming/Agriculture Activity,27,0,27
JHARKHAND,2001,Others (Please Specify),36,15,51
JHARKHAND,2001,Retired Person,0,0,0
JHARKHAND,2001,Others (Please Specify),40,29,69
JHARKHAND,2001,Total,141,109,250
JHARKHAND,2001,Total Salaried,7,4,11
JHARKHAND,2001,Total Self-employed,70,15,85
JHARKHAND,2002,House Wife,0,63,63
JHARKHAND,2002,Service (Government),0,0,0
JHARKHAND,2002,Service (Private),5,3,8
JHARKHAND,2002,Public Sector Undertaking,3,3,6
JHARKHAND,2002,Student,7,3,10
JHARKHAND,2002,Unemployed,27,2,29
JHARKHAND,2002,Self-employed (Business activity),3,1,4
JHARKHAND,2002,Professional Activity,9,0,9
JHARKHAND,2002,Farming/Agriculture Activity,21,0,21
JHARKHAND,2002,Others (Please Specify),34,12,46
JHARKHAND,2002,Retired Person,2,0,2
JHARKHAND,2002,Others (Please Specify),42,32,74
JHARKHAND,2002,Total,153,119,272
JHARKHAND,2002,Total Salaried,8,6,14
JHARKHAND,2002,Total Self-employed,67,13,80
JHARKHAND,2003,House Wife,0,63,63
JHARKHAND,2003,Service (Government),0,0,0
JHARKHAND,2003,Service (Private),5,3,8
JHARKHAND,2003,Public Sector Undertaking,3,3,6
JHARKHAND,2003,Student,7,3,10
JHARKHAND,2003,Unemployed,27,2,29
JHARKHAND,2003,Self-employed (Business activity),3,1,4
JHARKHAND,2003,Professional Activity,9,0,9
JHARKHAND,2003,Farming/Agriculture Activity,21,0,21
JHARKHAND,2003,Others (Please Specify),34,12,46
JHARKHAND,2003,Retired Person,2,0,2
JHARKHAND,2003,Others (Please Specify),42,32,74
JHARKHAND,2003,Total,153,119,272
JHARKHAND,2003,Total Salaried,8,6,14
JHARKHAND,2003,Total Self-employed,67,13,80
JHARKHAND,2004,House Wife,0,0,0
JHARKHAND,2004,Service (Government),0,0,0
JHARKHAND,2004,Service (Private),5,3,8
JHARKHAND,2004,Public Sector Undertaking,3,3,6
JHARKHAND,2004,Student,7,3,10
JHARKHAND,2004,Unemployed,27,2,29
JHARKHAND,2004,Self-employed (Business activity),3,1,4
JHARKHAND,2004,Professional Activity,9,0,9
JHARKHAND,2004,Farming/Agriculture Activity,21,0,21
JHARKHAND,2004,Others (Please Specify),34,12,46
JHARKHAND,2004,Retired Person,0,0,0
JHARKHAND,2004,Others (Please Specify),124,160,284
JHARKHAND,2004,Total,233,184,417
JHARKHAND,2004,Total Salaried,8,6,14
JHARKHAND,2004,Total Self-employed,67,13,80
JHARKHAND,2005,House Wife,0,158,158
JHARKHAND,2005,Service (Government),9,2,11
JHARKHAND,2005,Service (Private),33,9,42
JHARKHAND,2005,Public Sector Undertaking,5,1,6
JHARKHAND,2005,Student,69,29,98
JHARKHAND,2005,Unemployed,26,22,48
JHARKHAND,2005,Self-employed (Business activity),33,1,34
JHARKHAND,2005,Professional Activity,9,0,9
JHARKHAND,2005,Farming/Agriculture Activity,124,0,124
JHARKHAND,2005,Others (Please Specify),55,35,90
JHARKHAND,2005,Retired Person,3,0,3
JHARKHAND,2005,Others (Please Specify),157,28,185
JHARKHAND,2005,Total,523,285,808
JHARKHAND,2005,Total Salaried,47,12,59
JHARKHAND,2005,Total Self-employed,221,36,257
JHARKHAND,2006,House Wife,0,190,190
JHARKHAND,2006,Service (Government),20,6,26
JHARKHAND,2006,Service (Private),40,8,48
JHARKHAND,2006,Public Sector Undertaking,1,0,1
JHARKHAND,2006,Student,71,40,111
JHARKHAND,2006,Unemployed,81,14,95
JHARKHAND,2006,Self-employed (Business activity),18,2,20
JHARKHAND,2006,Professional Activity,34,0,34
JHARKHAND,2006,Farming/Agriculture Activity,103,0,103
JHARKHAND,2006,Others (Please Specify),53,4,57
JHARKHAND,2006,Retired Person,9,0,9
JHARKHAND,2006,Others (Please Specify),91,71,162
JHARKHAND,2006,Total,521,335,856
JHARKHAND,2006,Total Salaried,61,14,75
JHARKHAND,2006,Total Self-employed,208,6,214
JHARKHAND,2007,House Wife,0,205,205
JHARKHAND,2007,Service (Government),19,1,20
JHARKHAND,2007,Service (Private),80,4,84
JHARKHAND,2007,Public Sector Undertaking,0,0,0
JHARKHAND,2007,Student,67,35,102
JHARKHAND,2007,Unemployed,79,16,95
JHARKHAND,2007,Self-employed (Business activity),49,4,53
JHARKHAND,2007,Professional Activity,40,2,42
JHARKHAND,2007,Farming/Agriculture Activity,101,12,113
JHARKHAND,2007,Others (Please Specify),72,49,121
JHARKHAND,2007,Retired Person,19,0,19
JHARKHAND,2007,Others (Please Specify),354,81,435
JHARKHAND,2007,Total,880,409,1289
JHARKHAND,2007,Total Salaried,99,5,104
JHARKHAND,2007,Total Self-employed,262,67,329
JHARKHAND,2008,House Wife,0,170,170
JHARKHAND,2008,Service (Government),12,1,13
JHARKHAND,2008,Service (Private),31,4,35
JHARKHAND,2008,Public Sector Undertaking,14,0,14
JHARKHAND,2008,Student,61,40,101
JHARKHAND,2008,Unemployed,50,10,60
JHARKHAND,2008,Self-employed (Business activity),32,3,35
JHARKHAND,2008,Professional Activity,43,5,48
JHARKHAND,2008,Farming/Agriculture Activity,64,7,71
JHARKHAND,2008,Others (Please Specify),106,15,121
JHARKHAND,2008,Retired Person,4,0,4
JHARKHAND,2008,Others (Please Specify),185,54,239
JHARKHAND,2008,Total,602,309,911
JHARKHAND,2008,Total Salaried,57,5,62
JHARKHAND,2008,Total Self-employed,245,30,275
JHARKHAND,2009,House Wife,0,185,185
JHARKHAND,2009,Service (Government),17,7,24
JHARKHAND,2009,Service (Private),120,16,136
JHARKHAND,2009,Public Sector Undertaking,3,1,4
JHARKHAND,2009,Student,63,33,96
JHARKHAND,2009,Unemployed,87,13,100
JHARKHAND,2009,Self-employed (Business activity),33,4,37
JHARKHAND,2009,Professional Activity,20,2,22
JHARKHAND,2009,Farming/Agriculture Activity,159,5,164
JHARKHAND,2009,Others (Please Specify),77,23,100
JHARKHAND,2009,Retired Person,1,0,1
JHARKHAND,2009,Others (Please Specify),164,79,243
JHARKHAND,2009,Total,744,368,1112
JHARKHAND,2009,Total Salaried,140,24,164
JHARKHAND,2009,Total Self-employed,289,34,323
JHARKHAND,2010,House Wife,0,212,212
JHARKHAND,2010,Service (Government),8,2,10
JHARKHAND,2010,Service (Private),77,10,87
JHARKHAND,2010,Public Sector Undertaking,24,4,28
JHARKHAND,2010,Student,92,50,142
JHARKHAND,2010,Unemployed,88,12,100
JHARKHAND,2010,Self-employed (Business activity),27,4,31
JHARKHAND,2010,Professional Activity,9,0,9
JHARKHAND,2010,Farming/Agriculture Activity,150,23,173
JHARKHAND,2010,Others (Please Specify),132,62,194
JHARKHAND,2010,Retired Person,3,0,3
JHARKHAND,2010,Others (Please Specify),185,58,243
JHARKHAND,2010,Total,795,437,1232
JHARKHAND,2010,Total Salaried,109,16,125
JHARKHAND,2010,Total Self-employed,318,89,407
JHARKHAND,2011,House Wife,0,206,206
JHARKHAND,2011,Service (Government),15,7,22
JHARKHAND,2011,Service (Private),105,9,114
JHARKHAND,2011,Public Sector Undertaking,20,11,31
JHARKHAND,2011,Student,51,44,95
JHARKHAND,2011,Unemployed,85,6,91
JHARKHAND,2011,Self-employed (Business activity),21,0,21
JHARKHAND,2011,Professional Activity,49,6,55
JHARKHAND,2011,Farming/Agriculture Activity,90,4,94
JHARKHAND,2011,Others (Please Specify),62,24,86
JHARKHAND,2011,Retired Person,7,0,7
JHARKHAND,2011,Others (Please Specify),320,70,390
JHARKHAND,2011,Total,825,387,1212
JHARKHAND,2011,Total Salaried,140,27,167
JHARKHAND,2011,Total Self-employed,222,34,256
JHARKHAND,2012,House Wife,0,212,212
JHARKHAND,2012,Service (Government),17,2,19
JHARKHAND,2012,Service (Private),78,11,89
JHARKHAND,2012,Public Sector Undertaking,13,6,19
JHARKHAND,2012,Student,118,57,175
JHARKHAND,2012,Unemployed,126,32,158
JHARKHAND,2012,Self-employed (Business activity),48,17,65
JHARKHAND,2012,Professional Activity,22,0,22
JHARKHAND,2012,Farming/Agriculture Activity,93,26,119
JHARKHAND,2012,Others (Please Specify),107,22,129
JHARKHAND,2012,Retired Person,3,0,3
JHARKHAND,2012,Others (Please Specify),213,96,309
JHARKHAND,2012,Total,838,481,1319
JHARKHAND,2012,Total Salaried,108,19,127
JHARKHAND,2012,Total Self-employed,270,65,335
KARNATAKA,2001,House Wife,0,2197,2197
KARNATAKA,2001,Service (Government),211,59,270
KARNATAKA,2001,Service (Private),865,200,1065
KARNATAKA,2001,Public Sector Undertaking,228,15,243
KARNATAKA,2001,Student,329,183,512
KARNATAKA,2001,Unemployed,558,85,643
KARNATAKA,2001,Self-employed (Business activity),591,34,625
KARNATAKA,2001,Professional Activity,195,8,203
KARNATAKA,2001,Farming/Agriculture Activity,2153,352,2505
KARNATAKA,2001,Others (Please Specify),1947,517,2464
KARNATAKA,2001,Retired Person,96,39,135
KARNATAKA,2001,Others (Please Specify),698,321,1019
KARNATAKA,2001,Total,7871,4010,11881
KARNATAKA,2001,Total Salaried,1304,274,1578
KARNATAKA,2001,Total Self-employed,4886,911,5797
KARNATAKA,2002,House Wife,0,2225,2225
KARNATAKA,2002,Service (Government),186,34,220
KARNATAKA,2002,Service (Private),888,179,1067
KARNATAKA,2002,Public Sector Undertaking,183,24,207
KARNATAKA,2002,Student,255,254,509
KARNATAKA,2002,Unemployed,543,108,651
KARNATAKA,2002,Self-employed (Business activity),755,39,794
KARNATAKA,2002,Professional Activity,92,7,99
KARNATAKA,2002,Farming/Agriculture Activity,2008,332,2340
KARNATAKA,2002,Others (Please Specify),2426,603,3029
KARNATAKA,2002,Retired Person,52,15,67
KARNATAKA,2002,Others (Please Specify),692,370,1062
KARNATAKA,2002,Total,8080,4190,12270
KARNATAKA,2002,Total Salaried,1257,237,1494
KARNATAKA,2002,Total Self-employed,5281,981,6262
KARNATAKA,2003,House Wife,0,1864,1864
KARNATAKA,2003,Service (Government),198,25,223
KARNATAKA,2003,Service (Private),688,164,852
KARNATAKA,2003,Public Sector Undertaking,212,34,246
KARNATAKA,2003,Student,227,195,422
KARNATAKA,2003,Unemployed,650,107,757
KARNATAKA,2003,Self-employed (Business activity),544,20,564
KARNATAKA,2003,Professional Activity,136,8,144
KARNATAKA,2003,Farming/Agriculture Activity,2326,352,2678
KARNATAKA,2003,Others (Please Specify),2111,630,2741
KARNATAKA,2003,Retired Person,46,6,52
KARNATAKA,2003,Others (Please Specify),1237,581,1818
KARNATAKA,2003,Total,8375,3986,12361
KARNATAKA,2003,Total Salaried,1098,223,1321
KARNATAKA,2003,Total Self-employed,5117,1010,6127
KARNATAKA,2004,House Wife,0,1783,1783
KARNATAKA,2004,Service (Government),165,34,199
KARNATAKA,2004,Service (Private),887,218,1105
KARNATAKA,2004,Public Sector Undertaking,169,49,218
KARNATAKA,2004,Student,232,216,448
KARNATAKA,2004,Unemployed,526,85,611
KARNATAKA,2004,Self-employed (Business activity),471,23,494
KARNATAKA,2004,Professional Activity,85,0,85
KARNATAKA,2004,Farming/Agriculture Activity,1706,257,1963
KARNATAKA,2004,Others (Please Specify),2055,637,2692
KARNATAKA,2004,Retired Person,75,0,75
KARNATAKA,2004,Others (Please Specify),1647,617,2264
KARNATAKA,2004,Total,8018,3919,11937
KARNATAKA,2004,Total Salaried,1221,301,1522
KARNATAKA,2004,Total Self-employed,4317,917,5234
KARNATAKA,2005,House Wife,0,1874,1874
KARNATAKA,2005,Service (Government),139,21,160
KARNATAKA,2005,Service (Private),889,124,1013
KARNATAKA,2005,Public Sector Undertaking,184,34,218
KARNATAKA,2005,Student,189,179,368
KARNATAKA,2005,Unemployed,403,66,469
KARNATAKA,2005,Self-employed (Business activity),402,46,448
KARNATAKA,2005,Professional Activity,242,36,278
KARNATAKA,2005,Farming/Agriculture Activity,1663,220,1883
KARNATAKA,2005,Others (Please Specify),1782,491,2273
KARNATAKA,2005,Retired Person,35,5,40
KARNATAKA,2005,Others (Please Specify),1779,754,2533
KARNATAKA,2005,Total,7707,3850,11557
KARNATAKA,2005,Total Salaried,1212,179,1391
KARNATAKA,2005,Total Self-employed,4089,793,4882
KARNATAKA,2006,House Wife,0,1851,1851
KARNATAKA,2006,Service (Government),214,24,238
KARNATAKA,2006,Service (Private),1038,144,1182
KARNATAKA,2006,Public Sector Undertaking,136,34,170
KARNATAKA,2006,Student,230,217,447
KARNATAKA,2006,Unemployed,398,90,488
KARNATAKA,2006,Self-employed (Business activity),396,44,440
KARNATAKA,2006,Professional Activity,210,13,223
KARNATAKA,2006,Farming/Agriculture Activity,1450,270,1720
KARNATAKA,2006,Others (Please Specify),1699,361,2060
KARNATAKA,2006,Retired Person,28,1,29
KARNATAKA,2006,Others (Please Specify),2249,1115,3364
KARNATAKA,2006,Total,8048,4164,12212
KARNATAKA,2006,Total Salaried,1388,202,1590
KARNATAKA,2006,Total Self-employed,3755,688,4443
KARNATAKA,2007,House Wife,0,1802,1802
KARNATAKA,2007,Service (Government),179,28,207
KARNATAKA,2007,Service (Private),902,174,1076
KARNATAKA,2007,Public Sector Undertaking,176,27,203
KARNATAKA,2007,Student,246,261,507
KARNATAKA,2007,Unemployed,450,102,552
KARNATAKA,2007,Self-employed (Business activity),421,63,484
KARNATAKA,2007,Professional Activity,187,7,194
KARNATAKA,2007,Farming/Agriculture Activity,1772,363,2135
KARNATAKA,2007,Others (Please Specify),2133,541,2674
KARNATAKA,2007,Retired Person,47,4,51
KARNATAKA,2007,Others (Please Specify),1879,540,2419
KARNATAKA,2007,Total,8392,3912,12304
KARNATAKA,2007,Total Salaried,1257,229,1486
KARNATAKA,2007,Total Self-employed,4513,974,5487
KARNATAKA,2008,House Wife,0,1653,1653
KARNATAKA,2008,Service (Government),196,53,249
KARNATAKA,2008,Service (Private),1054,212,1266
KARNATAKA,2008,Public Sector Undertaking,235,69,304
KARNATAKA,2008,Student,243,212,455
KARNATAKA,2008,Unemployed,401,93,494
KARNATAKA,2008,Self-employed (Business activity),544,40,584
KARNATAKA,2008,Professional Activity,118,22,140
KARNATAKA,2008,Farming/Agriculture Activity,1439,298,1737
KARNATAKA,2008,Others (Please Specify),1914,460,2374
KARNATAKA,2008,Retired Person,51,6,57
KARNATAKA,2008,Others (Please Specify),2021,888,2909
KARNATAKA,2008,Total,8216,4006,12222
KARNATAKA,2008,Total Salaried,1485,334,1819
KARNATAKA,2008,Total Self-employed,4015,820,4835
KARNATAKA,2009,House Wife,0,1696,1696
KARNATAKA,2009,Service (Government),92,15,107
KARNATAKA,2009,Service (Private),733,122,855
KARNATAKA,2009,Public Sector Undertaking,244,48,292
KARNATAKA,2009,Student,274,233,507
KARNATAKA,2009,Unemployed,480,55,535
KARNATAKA,2009,Self-employed (Business activity),636,30,666
KARNATAKA,2009,Professional Activity,144,11,155
KARNATAKA,2009,Farming/Agriculture Activity,1915,367,2282
KARNATAKA,2009,Others (Please Specify),1958,765,2723
KARNATAKA,2009,Retired Person,49,6,55
KARNATAKA,2009,Others (Please Specify),1684,638,2322
KARNATAKA,2009,Total,8209,3986,12195
KARNATAKA,2009,Total Salaried,1069,185,1254
KARNATAKA,2009,Total Self-employed,4653,1173,5826
KARNATAKA,2010,House Wife,0,1889,1889
KARNATAKA,2010,Service (Government),178,40,218
KARNATAKA,2010,Service (Private),889,227,1116
KARNATAKA,2010,Public Sector Undertaking,254,41,295
KARNATAKA,2010,Student,319,272,591
KARNATAKA,2010,Unemployed,362,58,420
KARNATAKA,2010,Self-employed (Business activity),845,43,888
KARNATAKA,2010,Professional Activity,110,15,125
KARNATAKA,2010,Farming/Agriculture Activity,2128,457,2585
KARNATAKA,2010,Others (Please Specify),2029,637,2666
KARNATAKA,2010,Retired Person,91,9,100
KARNATAKA,2010,Others (Please Specify),1202,556,1758
KARNATAKA,2010,Total,8407,4244,12651
KARNATAKA,2010,Total Salaried,1321,308,1629
KARNATAKA,2010,Total Self-employed,5112,1152,6264
KARNATAKA,2011,House Wife,0,1776,1776
KARNATAKA,2011,Service (Government),160,31,191
KARNATAKA,2011,Service (Private),761,233,994
KARNATAKA,2011,Public Sector Undertaking,362,77,439
KARNATAKA,2011,Student,425,286,711
KARNATAKA,2011,Unemployed,800,124,924
KARNATAKA,2011,Self-employed (Business activity),770,56,826
KARNATAKA,2011,Professional Activity,166,30,196
KARNATAKA,2011,Farming/Agriculture Activity,1694,406,2100
KARNATAKA,2011,Others (Please Specify),1898,448,2346
KARNATAKA,2011,Retired Person,55,8,63
KARNATAKA,2011,Others (Please Specify),1381,675,2056
KARNATAKA,2011,Total,8472,4150,12622
KARNATAKA,2011,Total Salaried,1283,341,1624
KARNATAKA,2011,Total Self-employed,4528,940,5468
KARNATAKA,2012,House Wife,0,1850,1850
KARNATAKA,2012,Service (Government),174,29,203
KARNATAKA,2012,Service (Private),1000,261,1261
KARNATAKA,2012,Public Sector Undertaking,254,88,342
KARNATAKA,2012,Student,296,264,560
KARNATAKA,2012,Unemployed,633,82,715
KARNATAKA,2012,Self-employed (Business activity),608,34,642
KARNATAKA,2012,Professional Activity,268,33,301
KARNATAKA,2012,Farming/Agriculture Activity,1516,359,1875
KARNATAKA,2012,Others (Please Specify),2627,614,3241
KARNATAKA,2012,Retired Person,60,9,69
KARNATAKA,2012,Others (Please Specify),1160,534,1694
KARNATAKA,2012,Total,8596,4157,12753
KARNATAKA,2012,Total Salaried,1428,378,1806
KARNATAKA,2012,Total Self-employed,5019,1040,6059
KERALA,2001,House Wife,0,1406,1406
KERALA,2001,Service (Government),176,31,207
KERALA,2001,Service (Private),449,117,566
KERALA,2001,Public Sector Undertaking,183,27,210
KERALA,2001,Student,128,153,281
KERALA,2001,Unemployed,1756,339,2095
KERALA,2001,Self-employed (Business activity),475,22,497
KERALA,2001,Professional Activity,202,21,223
KERALA,2001,Farming/Agriculture Activity,974,61,1035
KERALA,2001,Others (Please Specify),1535,292,1827
KERALA,2001,Retired Person,99,20,119
KERALA,2001,Others (Please Specify),810,296,1106
KERALA,2001,Total,6787,2785,9572
KERALA,2001,Total Salaried,808,175,983
KERALA,2001,Total Self-employed,3186,396,3582
KERALA,2002,House Wife,0,1453,1453
KERALA,2002,Service (Government),152,20,172
KERALA,2002,Service (Private),397,76,473
KERALA,2002,Public Sector Undertaking,96,21,117
KERALA,2002,Student,146,136,282
KERALA,2002,Unemployed,1599,340,1939
KERALA,2002,Self-employed (Business activity),631,16,647
KERALA,2002,Professional Activity,291,22,313
KERALA,2002,Farming/Agriculture Activity,1433,100,1533
KERALA,2002,Others (Please Specify),1190,212,1402
KERALA,2002,Retired Person,120,17,137
KERALA,2002,Others (Please Specify),1110,232,1342
KERALA,2002,Total,7165,2645,9810
KERALA,2002,Total Salaried,645,117,762
KERALA,2002,Total Self-employed,3545,350,3895
KERALA,2003,House Wife,0,1431,1431
KERALA,2003,Service (Government),86,19,105
KERALA,2003,Service (Private),325,41,366
KERALA,2003,Public Sector Undertaking,63,12,75
KERALA,2003,Student,160,154,314
KERALA,2003,Unemployed,883,216,1099
KERALA,2003,Self-employed (Business activity),389,7,396
KERALA,2003,Professional Activity,149,6,155
KERALA,2003,Farming/Agriculture Activity,1520,63,1583
KERALA,2003,Others (Please Specify),2306,417,2723
KERALA,2003,Retired Person,76,7,83
KERALA,2003,Others (Please Specify),978,130,1108
KERALA,2003,Total,6935,2503,9438
KERALA,2003,Total Salaried,474,72,546
KERALA,2003,Total Self-employed,4364,493,4857
KERALA,2004,House Wife,0,1513,1513
KERALA,2004,Service (Government),83,5,88
KERALA,2004,Service (Private),220,28,248
KERALA,2004,Public Sector Undertaking,31,8,39
KERALA,2004,Student,143,193,336
KERALA,2004,Unemployed,1006,258,1264
KERALA,2004,Self-employed (Business activity),385,1,386
KERALA,2004,Professional Activity,150,6,156
KERALA,2004,Farming/Agriculture Activity,860,43,903
KERALA,2004,Others (Please Specify),2534,227,2761
KERALA,2004,Retired Person,84,9,93
KERALA,2004,Others (Please Specify),1102,164,1266
KERALA,2004,Total,6598,2455,9053
KERALA,2004,Total Salaried,334,41,375
KERALA,2004,Total Self-employed,3929,277,4206
KERALA,2005,House Wife,0,1413,1413
KERALA,2005,Service (Government),67,18,85
KERALA,2005,Service (Private),273,49,322
KERALA,2005,Public Sector Undertaking,46,10,56
KERALA,2005,Student,140,141,281
KERALA,2005,Unemployed,980,241,1221
KERALA,2005,Self-employed (Business activity),395,5,400
KERALA,2005,Professional Activity,151,11,162
KERALA,2005,Farming/Agriculture Activity,1073,45,1118
KERALA,2005,Others (Please Specify),2437,312,2749
KERALA,2005,Retired Person,92,12,104
KERALA,2005,Others (Please Specify),1176,157,1333
KERALA,2005,Total,6830,2414,9244
KERALA,2005,Total Salaried,386,77,463
KERALA,2005,Total Self-employed,4056,373,4429
KERALA,2006,House Wife,0,1350,1350
KERALA,2006,Service (Government),75,14,89
KERALA,2006,Service (Private),370,62,432
KERALA,2006,Public Sector Undertaking,58,20,78
KERALA,2006,Student,116,155,271
KERALA,2006,Unemployed,999,218,1217
KERALA,2006,Self-employed (Business activity),373,4,377
KERALA,2006,Professional Activity,210,20,230
KERALA,2006,Farming/Agriculture Activity,1028,96,1124
KERALA,2006,Others (Please Specify),2313,357,2670
KERALA,2006,Retired Person,111,17,128
KERALA,2006,Others (Please Specify),930,130,1060
KERALA,2006,Total,6583,2443,9026
KERALA,2006,Total Salaried,503,96,599
KERALA,2006,Total Self-employed,3924,477,4401
KERALA,2007,House Wife,0,1326,1326
KERALA,2007,Service (Government),88,11,99
KERALA,2007,Service (Private),390,78,468
KERALA,2007,Public Sector Undertaking,91,13,104
KERALA,2007,Student,115,160,275
KERALA,2007,Unemployed,672,174,846
KERALA,2007,Self-employed (Business activity),426,7,433
KERALA,2007,Professional Activity,194,12,206
KERALA,2007,Farming/Agriculture Activity,1158,74,1232
KERALA,2007,Others (Please Specify),2148,325,2473
KERALA,2007,Retired Person,88,6,94
KERALA,2007,Others (Please Specify),1218,188,1406
KERALA,2007,Total,6588,2374,8962
KERALA,2007,Total Salaried,569,102,671
KERALA,2007,Total Self-employed,3926,418,4344
KERALA,2008,House Wife,0,1320,1320
KERALA,2008,Service (Government),67,13,80
KERALA,2008,Service (Private),389,77,466
KERALA,2008,Public Sector Undertaking,76,10,86
KERALA,2008,Student,91,195,286
KERALA,2008,Unemployed,668,163,831
KERALA,2008,Self-employed (Business activity),374,9,383
KERALA,2008,Professional Activity,148,10,158
KERALA,2008,Farming/Agriculture Activity,768,52,820
KERALA,2008,Others (Please Specify),1829,332,2161
KERALA,2008,Retired Person,100,9,109
KERALA,2008,Others (Please Specify),1620,249,1869
KERALA,2008,Total,6130,2439,8569
KERALA,2008,Total Salaried,532,100,632
KERALA,2008,Total Self-employed,3119,403,3522
KERALA,2009,House Wife,0,1316,1316
KERALA,2009,Service (Government),57,15,72
KERALA,2009,Service (Private),354,80,434
KERALA,2009,Public Sector Undertaking,87,19,106
KERALA,2009,Student,107,167,274
KERALA,2009,Unemployed,620,183,803
KERALA,2009,Self-employed (Business activity),586,12,598
KERALA,2009,Professional Activity,213,15,228
KERALA,2009,Farming/Agriculture Activity,820,76,896
KERALA,2009,Others (Please Specify),1463,217,1680
KERALA,2009,Retired Person,83,12,95
KERALA,2009,Others (Please Specify),1932,321,2253
KERALA,2009,Total,6322,2433,8755
KERALA,2009,Total Salaried,498,114,612
KERALA,2009,Total Self-employed,3082,320,3402
KERALA,2010,House Wife,0,1219,1219
KERALA,2010,Service (Government),62,9,71
KERALA,2010,Service (Private),380,74,454
KERALA,2010,Public Sector Undertaking,136,12,148
KERALA,2010,Student,129,184,313
KERALA,2010,Unemployed,832,210,1042
KERALA,2010,Self-employed (Business activity),464,15,479
KERALA,2010,Professional Activity,175,11,186
KERALA,2010,Farming/Agriculture Activity,797,98,895
KERALA,2010,Others (Please Specify),1795,192,1987
KERALA,2010,Retired Person,66,10,76
KERALA,2010,Others (Please Specify),1510,206,1716
KERALA,2010,Total,6346,2240,8586
KERALA,2010,Total Salaried,578,95,673
KERALA,2010,Total Self-employed,3231,316,3547
KERALA,2011,House Wife,0,1214,1214
KERALA,2011,Service (Government),54,13,67
KERALA,2011,Service (Private),354,78,432
KERALA,2011,Public Sector Undertaking,51,2,53
KERALA,2011,Student,89,157,246
KERALA,2011,Unemployed,430,115,545
KERALA,2011,Self-employed (Business activity),353,7,360
KERALA,2011,Professional Activity,155,12,167
KERALA,2011,Farming/Agriculture Activity,732,98,830
KERALA,2011,Others (Please Specify),2217,293,2510
KERALA,2011,Retired Person,98,6,104
KERALA,2011,Others (Please Specify),1679,224,1903
KERALA,2011,Total,6212,2219,8431
KERALA,2011,Total Salaried,459,93,552
KERALA,2011,Total Self-employed,3457,410,3867
KERALA,2012,House Wife,0,1194,1194
KERALA,2012,Service (Government),52,9,61
KERALA,2012,Service (Private),483,80,563
KERALA,2012,Public Sector Undertaking,75,7,82
KERALA,2012,Student,90,173,263
KERALA,2012,Unemployed,611,142,753
KERALA,2012,Self-employed (Business activity),468,11,479
KERALA,2012,Professional Activity,162,10,172
KERALA,2012,Farming/Agriculture Activity,982,99,1081
KERALA,2012,Others (Please Specify),1861,203,2064
KERALA,2012,Retired Person,79,11,90
KERALA,2012,Others (Please Specify),1546,142,1688
KERALA,2012,Total,6409,2081,8490
KERALA,2012,Total Salaried,610,96,706
KERALA,2012,Total Self-employed,3473,323,3796
MADHYA PRADESH,2001,House Wife,0,2201,2201
MADHYA PRADESH,2001,Service (Government),154,28,182
MADHYA PRADESH,2001,Service (Private),294,63,357
MADHYA PRADESH,2001,Public Sector Undertaking,62,44,106
MADHYA PRADESH,2001,Student,211,94,305
MADHYA PRADESH,2001,Unemployed,197,13,210
MADHYA PRADESH,2001,Self-employed (Business activity),217,71,288
MADHYA PRADESH,2001,Professional Activity,126,22,148
MADHYA PRADESH,2001,Farming/Agriculture Activity,1078,294,1372
MADHYA PRADESH,2001,Others (Please Specify),697,251,948
MADHYA PRADESH,2001,Retired Person,13,1,14
MADHYA PRADESH,2001,Others (Please Specify),487,242,729
MADHYA PRADESH,2001,Total,3536,3324,6860
MADHYA PRADESH,2001,Total Salaried,510,135,645
MADHYA PRADESH,2001,Total Self-employed,2118,638,2756
MADHYA PRADESH,2002,House Wife,0,2287,2287
MADHYA PRADESH,2002,Service (Government),190,28,218
MADHYA PRADESH,2002,Service (Private),376,59,435
MADHYA PRADESH,2002,Public Sector Undertaking,95,23,118
MADHYA PRADESH,2002,Student,215,122,337
MADHYA PRADESH,2002,Unemployed,275,43,318
MADHYA PRADESH,2002,Self-employed (Business activity),293,70,363
MADHYA PRADESH,2002,Professional Activity,108,24,132
MADHYA PRADESH,2002,Farming/Agriculture Activity,1041,299,1340
MADHYA PRADESH,2002,Others (Please Specify),788,291,1079
MADHYA PRADESH,2002,Retired Person,28,0,28
MADHYA PRADESH,2002,Others (Please Specify),170,74,244
MADHYA PRADESH,2002,Total,3579,3320,6899
MADHYA PRADESH,2002,Total Salaried,661,110,771
MADHYA PRADESH,2002,Total Self-employed,2230,684,2914
MADHYA PRADESH,2003,House Wife,0,2029,2029
MADHYA PRADESH,2003,Service (Government),204,62,266
MADHYA PRADESH,2003,Service (Private),325,74,399
MADHYA PRADESH,2003,Public Sector Undertaking,135,23,158
MADHYA PRADESH,2003,Student,184,138,322
MADHYA PRADESH,2003,Unemployed,219,12,231
MADHYA PRADESH,2003,Self-employed (Business activity),243,50,293
MADHYA PRADESH,2003,Professional Activity,189,22,211
MADHYA PRADESH,2003,Farming/Agriculture Activity,1103,342,1445
MADHYA PRADESH,2003,Others (Please Specify),564,422,986
MADHYA PRADESH,2003,Retired Person,23,0,23
MADHYA PRADESH,2003,Others (Please Specify),349,50,399
MADHYA PRADESH,2003,Total,3538,3224,6762
MADHYA PRADESH,2003,Total Salaried,664,159,823
MADHYA PRADESH,2003,Total Self-employed,2099,836,2935
MADHYA PRADESH,2004,House Wife,0,2112,2112
MADHYA PRADESH,2004,Service (Government),170,34,204
MADHYA PRADESH,2004,Service (Private),334,61,395
MADHYA PRADESH,2004,Public Sector Undertaking,99,51,150
MADHYA PRADESH,2004,Student,153,111,264
MADHYA PRADESH,2004,Unemployed,250,32,282
MADHYA PRADESH,2004,Self-employed (Business activity),267,58,325
MADHYA PRADESH,2004,Professional Activity,161,27,188
MADHYA PRADESH,2004,Farming/Agriculture Activity,1347,291,1638
MADHYA PRADESH,2004,Others (Please Specify),637,317,954
MADHYA PRADESH,2004,Retired Person,14,0,14
MADHYA PRADESH,2004,Others (Please Specify),202,67,269
MADHYA PRADESH,2004,Total,3634,3161,6795
MADHYA PRADESH,2004,Total Salaried,603,146,749
MADHYA PRADESH,2004,Total Self-employed,2412,693,3105
MADHYA PRADESH,2005,House Wife,0,1892,1892
MADHYA PRADESH,2005,Service (Government),43,11,54
MADHYA PRADESH,2005,Service (Private),168,47,215
MADHYA PRADESH,2005,Public Sector Undertaking,92,31,123
MADHYA PRADESH,2005,Student,130,69,199
MADHYA PRADESH,2005,Unemployed,212,27,239
MADHYA PRADESH,2005,Self-employed (Business activity),174,24,198
MADHYA PRADESH,2005,Professional Activity,131,30,161
MADHYA PRADESH,2005,Farming/Agriculture Activity,1055,193,1248
MADHYA PRADESH,2005,Others (Please Specify),616,176,792
MADHYA PRADESH,2005,Retired Person,8,0,8
MADHYA PRADESH,2005,Others (Please Specify),222,97,319
MADHYA PRADESH,2005,Total,2851,2597,5448
MADHYA PRADESH,2005,Total Salaried,303,89,392
MADHYA PRADESH,2005,Total Self-employed,1976,423,2399
MADHYA PRADESH,2006,House Wife,0,1901,1901
MADHYA PRADESH,2006,Service (Government),68,28,96
MADHYA PRADESH,2006,Service (Private),198,69,267
MADHYA PRADESH,2006,Public Sector Undertaking,105,24,129
MADHYA PRADESH,2006,Student,198,167,365
MADHYA PRADESH,2006,Unemployed,274,22,296
MADHYA PRADESH,2006,Self-employed (Business activity),199,8,207
MADHYA PRADESH,2006,Professional Activity,153,12,165
MADHYA PRADESH,2006,Farming/Agriculture Activity,1178,197,1375
MADHYA PRADESH,2006,Others (Please Specify),675,208,883
MADHYA PRADESH,2006,Retired Person,9,0,9
MADHYA PRADESH,2006,Others (Please Specify),446,296,742
MADHYA PRADESH,2006,Total,3503,2932,6435
MADHYA PRADESH,2006,Total Salaried,371,121,492
MADHYA PRADESH,2006,Total Self-employed,2205,425,2630
MADHYA PRADESH,2007,House Wife,0,1907,1907
MADHYA PRADESH,2007,Service (Government),70,17,87
MADHYA PRADESH,2007,Service (Private),169,80,249
MADHYA PRADESH,2007,Public Sector Undertaking,139,65,204
MADHYA PRADESH,2007,Student,191,135,326
MADHYA PRADESH,2007,Unemployed,258,28,286
MADHYA PRADESH,2007,Self-employed (Business activity),312,53,365
MADHYA PRADESH,2007,Professional Activity,182,12,194
MADHYA PRADESH,2007,Farming/Agriculture Activity,1065,198,1263
MADHYA PRADESH,2007,Others (Please Specify),657,245,902
MADHYA PRADESH,2007,Retired Person,20,2,22
MADHYA PRADESH,2007,Others (Please Specify),407,117,524
MADHYA PRADESH,2007,Total,3470,2859,6329
MADHYA PRADESH,2007,Total Salaried,378,162,540
MADHYA PRADESH,2007,Total Self-employed,2216,508,2724
MADHYA PRADESH,2008,House Wife,0,2073,2073
MADHYA PRADESH,2008,Service (Government),182,48,230
MADHYA PRADESH,2008,Service (Private),337,100,437
MADHYA PRADESH,2008,Public Sector Undertaking,228,9,237
MADHYA PRADESH,2008,Student,241,179,420
MADHYA PRADESH,2008,Unemployed,278,53,331
MADHYA PRADESH,2008,Self-employed (Business activity),307,24,331
MADHYA PRADESH,2008,Professional Activity,202,33,235
MADHYA PRADESH,2008,Farming/Agriculture Activity,1172,207,1379
MADHYA PRADESH,2008,Others (Please Specify),945,311,1256
MADHYA PRADESH,2008,Retired Person,18,0,18
MADHYA PRADESH,2008,Others (Please Specify),455,227,682
MADHYA PRADESH,2008,Total,4365,3264,7629
MADHYA PRADESH,2008,Total Salaried,747,157,904
MADHYA PRADESH,2008,Total Self-employed,2626,575,3201
MADHYA PRADESH,2009,House Wife,0,2286,2286
MADHYA PRADESH,2009,Service (Government),44,13,57
MADHYA PRADESH,2009,Service (Private),538,100,638
MADHYA PRADESH,2009,Public Sector Undertaking,31,4,35
MADHYA PRADESH,2009,Student,339,258,597
MADHYA PRADESH,2009,Unemployed,301,22,323
MADHYA PRADESH,2009,Self-employed (Business activity),581,23,604
MADHYA PRADESH,2009,Professional Activity,356,18,374
MADHYA PRADESH,2009,Farming/Agriculture Activity,1120,275,1395
MADHYA PRADESH,2009,Others (Please Specify),786,249,1035
MADHYA PRADESH,2009,Retired Person,15,0,15
MADHYA PRADESH,2009,Others (Please Specify),989,765,1754
MADHYA PRADESH,2009,Total,5100,4013,9113
MADHYA PRADESH,2009,Total Salaried,613,117,730
MADHYA PRADESH,2009,Total Self-employed,2843,565,3408
MADHYA PRADESH,2010,House Wife,0,2564,2564
MADHYA PRADESH,2010,Service (Government),102,12,114
MADHYA PRADESH,2010,Service (Private),344,58,402
MADHYA PRADESH,2010,Public Sector Undertaking,131,15,146
MADHYA PRADESH,2010,Student,268,191,459
MADHYA PRADESH,2010,Unemployed,308,66,374
MADHYA PRADESH,2010,Self-employed (Business activity),371,0,371
MADHYA PRADESH,2010,Professional Activity,292,28,320
MADHYA PRADESH,2010,Farming/Agriculture Activity,973,264,1237
MADHYA PRADESH,2010,Others (Please Specify),1425,529,1954
MADHYA PRADESH,2010,Retired Person,11,5,16
MADHYA PRADESH,2010,Others (Please Specify),862,184,1046
MADHYA PRADESH,2010,Total,5087,3916,9003
MADHYA PRADESH,2010,Total Salaried,577,85,662
MADHYA PRADESH,2010,Total Self-employed,3061,821,3882
MADHYA PRADESH,2011,House Wife,0,2732,2732
MADHYA PRADESH,2011,Service (Government),95,17,112
MADHYA PRADESH,2011,Service (Private),496,75,571
MADHYA PRADESH,2011,Public Sector Undertaking,125,37,162
MADHYA PRADESH,2011,Student,265,186,451
MADHYA PRADESH,2011,Unemployed,213,50,263
MADHYA PRADESH,2011,Self-employed (Business activity),455,9,464
MADHYA PRADESH,2011,Professional Activity,248,19,267
MADHYA PRADESH,2011,Farming/Agriculture Activity,1132,194,1326
MADHYA PRADESH,2011,Others (Please Specify),1326,468,1794
MADHYA PRADESH,2011,Retired Person,20,23,43
MADHYA PRADESH,2011,Others (Please Specify),865,209,1074
MADHYA PRADESH,2011,Total,5240,4019,9259
MADHYA PRADESH,2011,Total Salaried,716,129,845
MADHYA PRADESH,2011,Total Self-employed,3161,690,3851
MADHYA PRADESH,2012,House Wife,0,2740,2740
MADHYA PRADESH,2012,Service (Government),83,17,100
MADHYA PRADESH,2012,Service (Private),611,87,698
MADHYA PRADESH,2012,Public Sector Undertaking,150,24,174
MADHYA PRADESH,2012,Student,331,264,595
MADHYA PRADESH,2012,Unemployed,351,91,442
MADHYA PRADESH,2012,Self-employed (Business activity),422,47,469
MADHYA PRADESH,2012,Professional Activity,402,61,463
MADHYA PRADESH,2012,Farming/Agriculture Activity,1038,134,1172
MADHYA PRADESH,2012,Others (Please Specify),1487,345,1832
MADHYA PRADESH,2012,Retired Person,27,2,29
MADHYA PRADESH,2012,Others (Please Specify),872,189,1061
MADHYA PRADESH,2012,Total,5774,4001,9775
MADHYA PRADESH,2012,Total Salaried,844,128,972
MADHYA PRADESH,2012,Total Self-employed,3349,587,3936
MAHARASHTRA,2001,House Wife,0,3351,3351
MAHARASHTRA,2001,Service (Government),222,37,259
MAHARASHTRA,2001,Service (Private),1284,145,1429
MAHARASHTRA,2001,Public Sector Undertaking,113,11,124
MAHARASHTRA,2001,Student,433,356,789
MAHARASHTRA,2001,Unemployed,956,101,1057
MAHARASHTRA,2001,Self-employed (Business activity),401,37,438
MAHARASHTRA,2001,Professional Activity,244,24,268
MAHARASHTRA,2001,Farming/Agriculture Activity,2945,591,3536
MAHARASHTRA,2001,Others (Please Specify),2405,579,2984
MAHARASHTRA,2001,Retired Person,170,12,182
MAHARASHTRA,2001,Others (Please Specify),165,36,201
MAHARASHTRA,2001,Total,9338,5280,14618
MAHARASHTRA,2001,Total Salaried,1619,193,1812
MAHARASHTRA,2001,Total Self-employed,5995,1231,7226
MAHARASHTRA,2002,House Wife,0,3415,3415
MAHARASHTRA,2002,Service (Government),220,28,248
MAHARASHTRA,2002,Service (Private),1166,131,1297
MAHARASHTRA,2002,Public Sector Undertaking,103,7,110
MAHARASHTRA,2002,Student,448,378,826
MAHARASHTRA,2002,Unemployed,896,102,998
MAHARASHTRA,2002,Self-employed (Business activity),520,52,572
MAHARASHTRA,2002,Professional Activity,407,28,435
MAHARASHTRA,2002,Farming/Agriculture Activity,3155,540,3695
MAHARASHTRA,2002,Others (Please Specify),2157,358,2515
MAHARASHTRA,2002,Retired Person,153,16,169
MAHARASHTRA,2002,Others (Please Specify),222,27,249
MAHARASHTRA,2002,Total,9447,5082,14529
MAHARASHTRA,2002,Total Salaried,1489,166,1655
MAHARASHTRA,2002,Total Self-employed,6239,978,7217
MAHARASHTRA,2003,House Wife,0,3522,3522
MAHARASHTRA,2003,Service (Government),246,30,276
MAHARASHTRA,2003,Service (Private),1432,171,1603
MAHARASHTRA,2003,Public Sector Undertaking,118,17,135
MAHARASHTRA,2003,Student,499,375,874
MAHARASHTRA,2003,Unemployed,887,81,968
MAHARASHTRA,2003,Self-employed (Business activity),519,26,545
MAHARASHTRA,2003,Professional Activity,270,16,286
MAHARASHTRA,2003,Farming/Agriculture Activity,3381,455,3836
MAHARASHTRA,2003,Others (Please Specify),2206,239,2445
MAHARASHTRA,2003,Retired Person,144,6,150
MAHARASHTRA,2003,Others (Please Specify),108,12,120
MAHARASHTRA,2003,Total,9810,4950,14760
MAHARASHTRA,2003,Total Salaried,1796,218,2014
MAHARASHTRA,2003,Total Self-employed,6376,736,7112
MAHARASHTRA,2004,House Wife,0,3501,3501
MAHARASHTRA,2004,Service (Government),201,43,244
MAHARASHTRA,2004,Service (Private),1345,101,1446
MAHARASHTRA,2004,Public Sector Undertaking,154,9,163
MAHARASHTRA,2004,Student,516,443,959
MAHARASHTRA,2004,Unemployed,1018,60,1078
MAHARASHTRA,2004,Self-employed (Business activity),505,27,532
MAHARASHTRA,2004,Professional Activity,310,9,319
MAHARASHTRA,2004,Farming/Agriculture Activity,3799,348,4147
MAHARASHTRA,2004,Others (Please Specify),1863,265,2128
MAHARASHTRA,2004,Retired Person,121,2,123
MAHARASHTRA,2004,Others (Please Specify),71,18,89
MAHARASHTRA,2004,Total,9903,4826,14729
MAHARASHTRA,2004,Total Salaried,1700,153,1853
MAHARASHTRA,2004,Total Self-employed,6477,649,7126
MAHARASHTRA,2005,House Wife,0,3582,3582
MAHARASHTRA,2005,Service (Government),260,40,300
MAHARASHTRA,2005,Service (Private),1485,121,1606
MAHARASHTRA,2005,Public Sector Undertaking,105,13,118
MAHARASHTRA,2005,Student,402,382,784
MAHARASHTRA,2005,Unemployed,950,79,1029
MAHARASHTRA,2005,Self-employed (Business activity),384,6,390
MAHARASHTRA,2005,Professional Activity,377,16,393
MAHARASHTRA,2005,Farming/Agriculture Activity,3638,288,3926
MAHARASHTRA,2005,Others (Please Specify),1767,267,2034
MAHARASHTRA,2005,Retired Person,114,7,121
MAHARASHTRA,2005,Others (Please Specify),121,22,143
MAHARASHTRA,2005,Total,9603,4823,14426
MAHARASHTRA,2005,Total Salaried,1850,174,2024
MAHARASHTRA,2005,Total Self-employed,6166,577,6743
MAHARASHTRA,2006,House Wife,0,3653,3653
MAHARASHTRA,2006,Service (Government),432,50,482
MAHARASHTRA,2006,Service (Private),1241,104,1345
MAHARASHTRA,2006,Public Sector Undertaking,160,12,172
MAHARASHTRA,2006,Student,444,438,882
MAHARASHTRA,2006,Unemployed,872,72,944
MAHARASHTRA,2006,Self-employed (Business activity),472,19,491
MAHARASHTRA,2006,Professional Activity,653,56,709
MAHARASHTRA,2006,Farming/Agriculture Activity,4111,342,4453
MAHARASHTRA,2006,Others (Please Specify),1757,214,1971
MAHARASHTRA,2006,Retired Person,132,8,140
MAHARASHTRA,2006,Others (Please Specify),236,16,252
MAHARASHTRA,2006,Total,10510,4984,15494
MAHARASHTRA,2006,Total Salaried,1833,166,1999
MAHARASHTRA,2006,Total Self-employed,6993,631,7624
MAHARASHTRA,2007,House Wife,0,3563,3563
MAHARASHTRA,2007,Service (Government),211,15,226
MAHARASHTRA,2007,Service (Private),1452,138,1590
MAHARASHTRA,2007,Public Sector Undertaking,115,20,135
MAHARASHTRA,2007,Student,404,389,793
MAHARASHTRA,2007,Unemployed,978,61,1039
MAHARASHTRA,2007,Self-employed (Business activity),434,10,444
MAHARASHTRA,2007,Professional Activity,681,66,747
MAHARASHTRA,2007,Farming/Agriculture Activity,3968,270,4238
MAHARASHTRA,2007,Others (Please Specify),1999,211,2210
MAHARASHTRA,2007,Retired Person,146,17,163
MAHARASHTRA,2007,Others (Please Specify),32,4,36
MAHARASHTRA,2007,Total,10420,4764,15184
MAHARASHTRA,2007,Total Salaried,1778,173,1951
MAHARASHTRA,2007,Total Self-employed,7082,557,7639
MAHARASHTRA,2008,House Wife,0,3384,3384
MAHARASHTRA,2008,Service (Government),147,10,157
MAHARASHTRA,2008,Service (Private),1560,93,1653
MAHARASHTRA,2008,Public Sector Undertaking,178,18,196
MAHARASHTRA,2008,Student,407,350,757
MAHARASHTRA,2008,Unemployed,796,77,873
MAHARASHTRA,2008,Self-employed (Business activity),458,11,469
MAHARASHTRA,2008,Professional Activity,481,59,540
MAHARASHTRA,2008,Farming/Agriculture Activity,3573,229,3802
MAHARASHTRA,2008,Others (Please Specify),2000,219,2219
MAHARASHTRA,2008,Retired Person,120,13,133
MAHARASHTRA,2008,Others (Please Specify),169,22,191
MAHARASHTRA,2008,Total,9889,4485,14374
MAHARASHTRA,2008,Total Salaried,1885,121,2006
MAHARASHTRA,2008,Total Self-employed,6512,518,7030
MAHARASHTRA,2009,House Wife,0,3383,3383
MAHARASHTRA,2009,Service (Government),139,15,154
MAHARASHTRA,2009,Service (Private),1610,120,1730
MAHARASHTRA,2009,Public Sector Undertaking,151,12,163
MAHARASHTRA,2009,Student,403,409,812
MAHARASHTRA,2009,Unemployed,821,52,873
MAHARASHTRA,2009,Self-employed (Business activity),412,7,419
MAHARASHTRA,2009,Professional Activity,591,39,630
MAHARASHTRA,2009,Farming/Agriculture Activity,2692,180,2872
MAHARASHTRA,2009,Others (Please Specify),2511,252,2763
MAHARASHTRA,2009,Retired Person,133,3,136
MAHARASHTRA,2009,Others (Please Specify),322,43,365
MAHARASHTRA,2009,Total,9785,4515,14300
MAHARASHTRA,2009,Total Salaried,1900,147,2047
MAHARASHTRA,2009,Total Self-employed,6206,478,6684
MAHARASHTRA,2010,House Wife,0,3639,3639
MAHARASHTRA,2010,Service (Government),173,10,183
MAHARASHTRA,2010,Service (Private),1714,143,1857
MAHARASHTRA,2010,Public Sector Undertaking,143,4,147
MAHARASHTRA,2010,Student,482,574,1056
MAHARASHTRA,2010,Unemployed,819,89,908
MAHARASHTRA,2010,Self-employed (Business activity),439,6,445
MAHARASHTRA,2010,Professional Activity,1040,83,1123
MAHARASHTRA,2010,Farming/Agriculture Activity,2947,194,3141
MAHARASHTRA,2010,Others (Please Specify),2668,283,2951
MAHARASHTRA,2010,Retired Person,113,4,117
MAHARASHTRA,2010,Others (Please Specify),320,29,349
MAHARASHTRA,2010,Total,10858,5058,15916
MAHARASHTRA,2010,Total Salaried,2030,157,2187
MAHARASHTRA,2010,Total Self-employed,7094,566,7660
MAHARASHTRA,2011,House Wife,0,3716,3716
MAHARASHTRA,2011,Service (Government),170,25,195
MAHARASHTRA,2011,Service (Private),1797,137,1934
MAHARASHTRA,2011,Public Sector Undertaking,76,10,86
MAHARASHTRA,2011,Student,481,507,988
MAHARASHTRA,2011,Unemployed,591,67,658
MAHARASHTRA,2011,Self-employed (Business activity),578,32,610
MAHARASHTRA,2011,Professional Activity,750,36,786
MAHARASHTRA,2011,Farming/Agriculture Activity,3093,244,3337
MAHARASHTRA,2011,Others (Please Specify),2721,255,2976
MAHARASHTRA,2011,Retired Person,144,3,147
MAHARASHTRA,2011,Others (Please Specify),486,28,514
MAHARASHTRA,2011,Total,10887,5060,15947
MAHARASHTRA,2011,Total Salaried,2043,172,2215
MAHARASHTRA,2011,Total Self-employed,7142,567,7709
MAHARASHTRA,2012,House Wife,0,3350,3350
MAHARASHTRA,2012,Service (Government),161,28,189
MAHARASHTRA,2012,Service (Private),2101,163,2264
MAHARASHTRA,2012,Public Sector Undertaking,209,13,222
MAHARASHTRA,2012,Student,449,472,921
MAHARASHTRA,2012,Unemployed,832,132,964
MAHARASHTRA,2012,Self-employed (Business activity),569,8,577
MAHARASHTRA,2012,Professional Activity,403,26,429
MAHARASHTRA,2012,Farming/Agriculture Activity,3483,303,3786
MAHARASHTRA,2012,Others (Please Specify),2133,229,2362
MAHARASHTRA,2012,Retired Person,143,3,146
MAHARASHTRA,2012,Others (Please Specify),821,81,902
MAHARASHTRA,2012,Total,11304,4808,16112
MAHARASHTRA,2012,Total Salaried,2471,204,2675
MAHARASHTRA,2012,Total Self-employed,6588,566,7154
MANIPUR,2001,House Wife,0,9,9
MANIPUR,2001,Service (Government),0,0,0
MANIPUR,2001,Service (Private),0,0,0
MANIPUR,2001,Public Sector Undertaking,3,0,3
MANIPUR,2001,Student,6,1,7
MANIPUR,2001,Unemployed,2,0,2
MANIPUR,2001,Self-employed (Business activity),0,0,0
MANIPUR,2001,Professional Activity,0,0,0
MANIPUR,2001,Farming/Agriculture Activity,0,0,0
MANIPUR,2001,Others (Please Specify),8,3,11
MANIPUR,2001,Retired Person,0,0,0
MANIPUR,2001,Others (Please Specify),5,4,9
MANIPUR,2001,Total,24,17,41
MANIPUR,2001,Total Salaried,3,0,3
MANIPUR,2001,Total Self-employed,8,3,11
MANIPUR,2002,House Wife,0,3,3
MANIPUR,2002,Service (Government),4,0,4
MANIPUR,2002,Service (Private),0,0,0
MANIPUR,2002,Public Sector Undertaking,4,0,4
MANIPUR,2002,Student,7,3,10
MANIPUR,2002,Unemployed,11,2,13
MANIPUR,2002,Self-employed (Business activity),0,0,0
MANIPUR,2002,Professional Activity,0,0,0
MANIPUR,2002,Farming/Agriculture Activity,3,0,3
MANIPUR,2002,Others (Please Specify),0,0,0
MANIPUR,2002,Retired Person,0,0,0
MANIPUR,2002,Others (Please Specify),1,1,2
MANIPUR,2002,Total,30,9,39
MANIPUR,2002,Total Salaried,8,0,8
MANIPUR,2002,Total Self-employed,3,0,3
MANIPUR,2003,House Wife,0,2,2
MANIPUR,2003,Service (Government),4,0,4
MANIPUR,2003,Service (Private),0,0,0
MANIPUR,2003,Public Sector Undertaking,0,0,0
MANIPUR,2003,Student,9,3,12
MANIPUR,2003,Unemployed,0,0,0
MANIPUR,2003,Self-employed (Business activity),4,0,4
MANIPUR,2003,Professional Activity,0,0,0
MANIPUR,2003,Farming/Agriculture Activity,4,0,4
MANIPUR,2003,Others (Please Specify),0,0,0
MANIPUR,2003,Retired Person,0,0,0
MANIPUR,2003,Others (Please Specify),0,0,0
MANIPUR,2003,Total,21,5,26
MANIPUR,2003,Total Salaried,4,0,4
MANIPUR,2003,Total Self-employed,8,0,8
MANIPUR,2004,House Wife,0,1,1
MANIPUR,2004,Service (Government),12,0,12
MANIPUR,2004,Service (Private),1,0,1
MANIPUR,2004,Public Sector Undertaking,0,0,0
MANIPUR,2004,Student,4,6,10
MANIPUR,2004,Unemployed,7,2,9
MANIPUR,2004,Self-employed (Business activity),3,0,3
MANIPUR,2004,Professional Activity,0,0,0
MANIPUR,2004,Farming/Agriculture Activity,2,0,2
MANIPUR,2004,Others (Please Specify),1,0,1
MANIPUR,2004,Retired Person,0,0,0
MANIPUR,2004,Others (Please Specify),2,0,2
MANIPUR,2004,Total,32,9,41
MANIPUR,2004,Total Salaried,13,0,13
MANIPUR,2004,Total Self-employed,6,0,6
MANIPUR,2005,House Wife,0,2,2
MANIPUR,2005,Service (Government),8,0,8
MANIPUR,2005,Service (Private),0,0,0
MANIPUR,2005,Public Sector Undertaking,0,0,0
MANIPUR,2005,Student,1,1,2
MANIPUR,2005,Unemployed,0,0,0
MANIPUR,2005,Self-employed (Business activity),4,0,4
MANIPUR,2005,Professional Activity,0,0,0
MANIPUR,2005,Farming/Agriculture Activity,2,0,2
MANIPUR,2005,Others (Please Specify),6,0,6
MANIPUR,2005,Retired Person,0,0,0
MANIPUR,2005,Others (Please Specify),2,1,3
MANIPUR,2005,Total,23,4,27
MANIPUR,2005,Total Salaried,8,0,8
MANIPUR,2005,Total Self-employed,12,0,12
MANIPUR,2006,House Wife,0,3,3
MANIPUR,2006,Service (Government),13,0,13
MANIPUR,2006,Service (Private),0,0,0
MANIPUR,2006,Public Sector Undertaking,0,0,0
MANIPUR,2006,Student,4,9,13
MANIPUR,2006,Unemployed,5,0,5
MANIPUR,2006,Self-employed (Business activity),0,0,0
MANIPUR,2006,Professional Activity,0,0,0
MANIPUR,2006,Farming/Agriculture Activity,0,0,0
MANIPUR,2006,Others (Please Specify),1,0,1
MANIPUR,2006,Retired Person,0,0,0
MANIPUR,2006,Others (Please Specify),1,0,1
MANIPUR,2006,Total,24,12,36
MANIPUR,2006,Total Salaried,13,0,13
MANIPUR,2006,Total Self-employed,1,0,1
MANIPUR,2007,House Wife,0,9,9
MANIPUR,2007,Service (Government),10,0,10
MANIPUR,2007,Service (Private),0,0,0
MANIPUR,2007,Public Sector Undertaking,0,0,0
MANIPUR,2007,Student,5,1,6
MANIPUR,2007,Unemployed,9,1,10
MANIPUR,2007,Self-employed (Business activity),0,0,0
MANIPUR,2007,Professional Activity,0,0,0
MANIPUR,2007,Farming/Agriculture Activity,0,0,0
MANIPUR,2007,Others (Please Specify),2,0,2
MANIPUR,2007,Retired Person,0,0,0
MANIPUR,2007,Others (Please Specify),2,0,2
MANIPUR,2007,Total,28,11,39
MANIPUR,2007,Total Salaried,10,0,10
MANIPUR,2007,Total Self-employed,2,0,2
MANIPUR,2008,House Wife,0,5,5
MANIPUR,2008,Service (Government),7,0,7
MANIPUR,2008,Service (Private),0,0,0
MANIPUR,2008,Public Sector Undertaking,0,0,0
MANIPUR,2008,Student,2,2,4
MANIPUR,2008,Unemployed,7,3,10
MANIPUR,2008,Self-employed (Business activity),0,0,0
MANIPUR,2008,Professional Activity,0,0,0
MANIPUR,2008,Farming/Agriculture Activity,2,0,2
MANIPUR,2008,Others (Please Specify),4,1,5
MANIPUR,2008,Retired Person,0,0,0
MANIPUR,2008,Others (Please Specify),1,0,1
MANIPUR,2008,Total,23,11,34
MANIPUR,2008,Total Salaried,7,0,7
MANIPUR,2008,Total Self-employed,6,1,7
MANIPUR,2009,House Wife,0,5,5
MANIPUR,2009,Service (Government),6,0,6
MANIPUR,2009,Service (Private),0,0,0
MANIPUR,2009,Public Sector Undertaking,0,0,0
MANIPUR,2009,Student,0,0,0
MANIPUR,2009,Unemployed,7,1,8
MANIPUR,2009,Self-employed (Business activity),0,0,0
MANIPUR,2009,Professional Activity,0,0,0
MANIPUR,2009,Farming/Agriculture Activity,0,1,1
MANIPUR,2009,Others (Please Specify),4,1,5
MANIPUR,2009,Retired Person,0,0,0
MANIPUR,2009,Others (Please Specify),1,1,2
MANIPUR,2009,Total,18,9,27
MANIPUR,2009,Total Salaried,6,0,6
MANIPUR,2009,Total Self-employed,4,2,6
MANIPUR,2010,House Wife,0,8,8
MANIPUR,2010,Service (Government),6,0,6
MANIPUR,2010,Service (Private),0,0,0
MANIPUR,2010,Public Sector Undertaking,0,0,0
MANIPUR,2010,Student,1,0,1
MANIPUR,2010,Unemployed,12,0,12
MANIPUR,2010,Self-employed (Business activity),0,0,0
MANIPUR,2010,Professional Activity,0,0,0
MANIPUR,2010,Farming/Agriculture Activity,0,4,4
MANIPUR,2010,Others (Please Specify),0,0,0
MANIPUR,2010,Retired Person,0,0,0
MANIPUR,2010,Others (Please Specify),5,1,6
MANIPUR,2010,Total,24,13,37
MANIPUR,2010,Total Salaried,6,0,6
MANIPUR,2010,Total Self-employed,0,4,4
MANIPUR,2011,House Wife,0,9,9
MANIPUR,2011,Service (Government),5,0,5
MANIPUR,2011,Service (Private),1,0,1
MANIPUR,2011,Public Sector Undertaking,0,0,0
MANIPUR,2011,Student,4,0,4
MANIPUR,2011,Unemployed,6,0,6
MANIPUR,2011,Self-employed (Business activity),0,0,0
MANIPUR,2011,Professional Activity,0,0,0
MANIPUR,2011,Farming/Agriculture Activity,0,0,0
MANIPUR,2011,Others (Please Specify),1,1,2
MANIPUR,2011,Retired Person,0,0,0
MANIPUR,2011,Others (Please Specify),1,5,6
MANIPUR,2011,Total,18,15,33
MANIPUR,2011,Total Salaried,6,0,6
MANIPUR,2011,Total Self-employed,1,1,2
MANIPUR,2012,House Wife,0,9,9
MANIPUR,2012,Service (Government),5,0,5
MANIPUR,2012,Service (Private),0,0,0
MANIPUR,2012,Public Sector Undertaking,0,0,0
MANIPUR,2012,Student,8,6,14
MANIPUR,2012,Unemployed,0,0,0
MANIPUR,2012,Self-employed (Business activity),0,0,0
MANIPUR,2012,Professional Activity,0,0,0
MANIPUR,2012,Farming/Agriculture Activity,0,0,0
MANIPUR,2012,Others (Please Specify),0,0,0
MANIPUR,2012,Retired Person,0,0,0
MANIPUR,2012,Others (Please Specify),10,3,13
MANIPUR,2012,Total,23,18,41
MANIPUR,2012,Total Salaried,5,0,5
MANIPUR,2012,Total Self-employed,0,0,0
MEGHALAYA,2001,House Wife,0,4,4
MEGHALAYA,2001,Service (Government),8,2,10
MEGHALAYA,2001,Service (Private),2,0,2
MEGHALAYA,2001,Public Sector Undertaking,0,0,0
MEGHALAYA,2001,Student,7,0,7
MEGHALAYA,2001,Unemployed,12,2,14
MEGHALAYA,2001,Self-employed (Business activity),4,0,4
MEGHALAYA,2001,Professional Activity,2,0,2
MEGHALAYA,2001,Farming/Agriculture Activity,2,2,4
MEGHALAYA,2001,Others (Please Specify),26,7,33
MEGHALAYA,2001,Retired Person,3,1,4
MEGHALAYA,2001,Others (Please Specify),3,0,3
MEGHALAYA,2001,Total,69,18,87
MEGHALAYA,2001,Total Salaried,10,2,12
MEGHALAYA,2001,Total Self-employed,34,9,43
MEGHALAYA,2002,House Wife,0,11,11
MEGHALAYA,2002,Service (Government),4,0,4
MEGHALAYA,2002,Service (Private),4,0,4
MEGHALAYA,2002,Public Sector Undertaking,0,0,0
MEGHALAYA,2002,Student,2,1,3
MEGHALAYA,2002,Unemployed,10,4,14
MEGHALAYA,2002,Self-employed (Business activity),3,0,3
MEGHALAYA,2002,Professional Activity,0,0,0
MEGHALAYA,2002,Farming/Agriculture Activity,8,0,8
MEGHALAYA,2002,Others (Please Specify),12,0,12
MEGHALAYA,2002,Retired Person,0,0,0
MEGHALAYA,2002,Others (Please Specify),6,2,8
MEGHALAYA,2002,Total,49,18,67
MEGHALAYA,2002,Total Salaried,8,0,8
MEGHALAYA,2002,Total Self-employed,23,0,23
MEGHALAYA,2003,House Wife,0,1,1
MEGHALAYA,2003,Service (Government),4,0,4
MEGHALAYA,2003,Service (Private),6,0,6
MEGHALAYA,2003,Public Sector Undertaking,0,0,0
MEGHALAYA,2003,Student,2,1,3
MEGHALAYA,2003,Unemployed,6,0,6
MEGHALAYA,2003,Self-employed (Business activity),0,1,1
MEGHALAYA,2003,Professional Activity,0,0,0
MEGHALAYA,2003,Farming/Agriculture Activity,4,0,4
MEGHALAYA,2003,Others (Please Specify),10,6,16
MEGHALAYA,2003,Retired Person,0,0,0
MEGHALAYA,2003,Others (Please Specify),0,0,0
MEGHALAYA,2003,Total,32,9,41
MEGHALAYA,2003,Total Salaried,10,0,10
MEGHALAYA,2003,Total Self-employed,14,7,21
MEGHALAYA,2004,House Wife,0,7,7
MEGHALAYA,2004,Service (Government),10,1,11
MEGHALAYA,2004,Service (Private),6,0,6
MEGHALAYA,2004,Public Sector Undertaking,2,0,2
MEGHALAYA,2004,Student,6,6,12
MEGHALAYA,2004,Unemployed,4,2,6
MEGHALAYA,2004,Self-employed (Business activity),0,0,0
MEGHALAYA,2004,Professional Activity,0,0,0
MEGHALAYA,2004,Farming/Agriculture Activity,11,0,11
MEGHALAYA,2004,Others (Please Specify),0,0,0
MEGHALAYA,2004,Retired Person,0,0,0
MEGHALAYA,2004,Others (Please Specify),0,0,0
MEGHALAYA,2004,Total,39,16,55
MEGHALAYA,2004,Total Salaried,18,1,19
MEGHALAYA,2004,Total Self-employed,11,0,11
MEGHALAYA,2005,House Wife,0,11,11
MEGHALAYA,2005,Service (Government),1,0,1
MEGHALAYA,2005,Service (Private),3,0,3
MEGHALAYA,2005,Public Sector Undertaking,1,0,1
MEGHALAYA,2005,Student,6,5,11
MEGHALAYA,2005,Unemployed,15,4,19
MEGHALAYA,2005,Self-employed (Business activity),3,0,3
MEGHALAYA,2005,Professional Activity,0,0,0
MEGHALAYA,2005,Farming/Agriculture Activity,4,0,4
MEGHALAYA,2005,Others (Please Specify),10,0,10
MEGHALAYA,2005,Retired Person,5,0,5
MEGHALAYA,2005,Others (Please Specify),2,1,3
MEGHALAYA,2005,Total,50,21,71
MEGHALAYA,2005,Total Salaried,5,0,5
MEGHALAYA,2005,Total Self-employed,17,0,17
MEGHALAYA,2006,House Wife,0,11,11
MEGHALAYA,2006,Service (Government),8,0,8
MEGHALAYA,2006,Service (Private),5,0,5
MEGHALAYA,2006,Public Sector Undertaking,1,0,1
MEGHALAYA,2006,Student,4,6,10
MEGHALAYA,2006,Unemployed,10,2,12
MEGHALAYA,2006,Self-employed (Business activity),18,0,18
MEGHALAYA,2006,Professional Activity,0,0,0
MEGHALAYA,2006,Farming/Agriculture Activity,3,0,3
MEGHALAYA,2006,Others (Please Specify),14,3,17
MEGHALAYA,2006,Retired Person,0,0,0
MEGHALAYA,2006,Others (Please Specify),6,1,7
MEGHALAYA,2006,Total,69,23,92
MEGHALAYA,2006,Total Salaried,14,0,14
MEGHALAYA,2006,Total Self-employed,35,3,38
MEGHALAYA,2007,House Wife,0,6,6
MEGHALAYA,2007,Service (Government),6,1,7
MEGHALAYA,2007,Service (Private),0,0,0
MEGHALAYA,2007,Public Sector Undertaking,1,0,1
MEGHALAYA,2007,Student,10,7,17
MEGHALAYA,2007,Unemployed,10,2,12
MEGHALAYA,2007,Self-employed (Business activity),9,0,9
MEGHALAYA,2007,Professional Activity,0,0,0
MEGHALAYA,2007,Farming/Agriculture Activity,14,4,18
MEGHALAYA,2007,Others (Please Specify),6,1,7
MEGHALAYA,2007,Retired Person,0,0,0
MEGHALAYA,2007,Others (Please Specify),4,6,10
MEGHALAYA,2007,Total,60,27,87
MEGHALAYA,2007,Total Salaried,7,1,8
MEGHALAYA,2007,Total Self-employed,29,5,34
MEGHALAYA,2008,House Wife,0,9,9
MEGHALAYA,2008,Service (Government),7,1,8
MEGHALAYA,2008,Service (Private),1,0,1
MEGHALAYA,2008,Public Sector Undertaking,0,0,0
MEGHALAYA,2008,Student,5,4,9
MEGHALAYA,2008,Unemployed,16,4,20
MEGHALAYA,2008,Self-employed (Business activity),0,0,0
MEGHALAYA,2008,Professional Activity,0,1,1
MEGHALAYA,2008,Farming/Agriculture Activity,9,0,9
MEGHALAYA,2008,Others (Please Specify),19,2,21
MEGHALAYA,2008,Retired Person,0,0,0
MEGHALAYA,2008,Others (Please Specify),0,7,7
MEGHALAYA,2008,Total,57,28,85
MEGHALAYA,2008,Total Salaried,8,1,9
MEGHALAYA,2008,Total Self-employed,28,3,31
MEGHALAYA,2009,House Wife,0,11,11
MEGHALAYA,2009,Service (Government),1,0,1
MEGHALAYA,2009,Service (Private),1,0,1
MEGHALAYA,2009,Public Sector Undertaking,2,0,2
MEGHALAYA,2009,Student,7,2,9
MEGHALAYA,2009,Unemployed,6,1,7
MEGHALAYA,2009,Self-employed (Business activity),3,0,3
MEGHALAYA,2009,Professional Activity,0,3,3
MEGHALAYA,2009,Farming/Agriculture Activity,16,5,21
MEGHALAYA,2009,Others (Please Specify),2,4,6
MEGHALAYA,2009,Retired Person,2,0,2
MEGHALAYA,2009,Others (Please Specify),27,19,46
MEGHALAYA,2009,Total,67,45,112
MEGHALAYA,2009,Total Salaried,4,0,4
MEGHALAYA,2009,Total Self-employed,21,12,33
MEGHALAYA,2010,House Wife,0,14,14
MEGHALAYA,2010,Service (Government),8,0,8
MEGHALAYA,2010,Service (Private),11,0,11
MEGHALAYA,2010,Public Sector Undertaking,1,0,1
MEGHALAYA,2010,Student,14,7,21
MEGHALAYA,2010,Unemployed,15,2,17
MEGHALAYA,2010,Self-employed (Business activity),0,0,0
MEGHALAYA,2010,Professional Activity,1,0,1
MEGHALAYA,2010,Farming/Agriculture Activity,15,1,16
MEGHALAYA,2010,Others (Please Specify),5,2,7
MEGHALAYA,2010,Retired Person,1,0,1
MEGHALAYA,2010,Others (Please Specify),9,2,11
MEGHALAYA,2010,Total,80,28,108
MEGHALAYA,2010,Total Salaried,20,0,20
MEGHALAYA,2010,Total Self-employed,21,3,24
MEGHALAYA,2011,House Wife,0,15,15
MEGHALAYA,2011,Service (Government),6,0,6
MEGHALAYA,2011,Service (Private),7,1,8
MEGHALAYA,2011,Public Sector Undertaking,2,0,2
MEGHALAYA,2011,Student,28,9,37
MEGHALAYA,2011,Unemployed,18,3,21
MEGHALAYA,2011,Self-employed (Business activity),10,0,10
MEGHALAYA,2011,Professional Activity,4,2,6
MEGHALAYA,2011,Farming/Agriculture Activity,16,6,22
MEGHALAYA,2011,Others (Please Specify),10,4,14
MEGHALAYA,2011,Retired Person,0,0,0
MEGHALAYA,2011,Others (Please Specify),10,2,12
MEGHALAYA,2011,Total,111,42,153
MEGHALAYA,2011,Total Salaried,15,1,16
MEGHALAYA,2011,Total Self-employed,40,12,52
MEGHALAYA,2012,House Wife,0,14,14
MEGHALAYA,2012,Service (Government),4,0,4
MEGHALAYA,2012,Service (Private),5,0,5
MEGHALAYA,2012,Public Sector Undertaking,1,0,1
MEGHALAYA,2012,Student,14,11,25
MEGHALAYA,2012,Unemployed,17,6,23
MEGHALAYA,2012,Self-employed (Business activity),18,0,18
MEGHALAYA,2012,Professional Activity,3,0,3
MEGHALAYA,2012,Farming/Agriculture Activity,9,1,10
MEGHALAYA,2012,Others (Please Specify),14,2,16
MEGHALAYA,2012,Retired Person,0,0,0
MEGHALAYA,2012,Others (Please Specify),5,4,9
MEGHALAYA,2012,Total,90,38,128
MEGHALAYA,2012,Total Salaried,10,0,10
MEGHALAYA,2012,Total Self-employed,44,3,47
MIZORAM,2001,House Wife,0,0,0
MIZORAM,2001,Service (Government),3,0,3
MIZORAM,2001,Service (Private),2,0,2
MIZORAM,2001,Public Sector Undertaking,0,0,0
MIZORAM,2001,Student,12,1,13
MIZORAM,2001,Unemployed,9,5,14
MIZORAM,2001,Self-employed (Business activity),0,0,0
MIZORAM,2001,Professional Activity,0,0,0
MIZORAM,2001,Farming/Agriculture Activity,0,0,0
MIZORAM,2001,Others (Please Specify),10,2,12
MIZORAM,2001,Retired Person,1,0,1
MIZORAM,2001,Others (Please Specify),9,0,9
MIZORAM,2001,Total,46,8,54
MIZORAM,2001,Total Salaried,5,0,5
MIZORAM,2001,Total Self-employed,10,2,12
MIZORAM,2002,House Wife,0,5,5
MIZORAM,2002,Service (Government),8,0,8
MIZORAM,2002,Service (Private),0,0,0
MIZORAM,2002,Public Sector Undertaking,4,0,4
MIZORAM,2002,Student,1,0,1
MIZORAM,2002,Unemployed,19,1,20
MIZORAM,2002,Self-employed (Business activity),0,0,0
MIZORAM,2002,Professional Activity,0,0,0
MIZORAM,2002,Farming/Agriculture Activity,3,0,3
MIZORAM,2002,Others (Please Specify),18,4,22
MIZORAM,2002,Retired Person,0,0,0
MIZORAM,2002,Others (Please Specify),3,0,3
MIZORAM,2002,Total,56,10,66
MIZORAM,2002,Total Salaried,12,0,12
MIZORAM,2002,Total Self-employed,21,4,25
MIZORAM,2003,House Wife,0,0,0
MIZORAM,2003,Service (Government),4,0,4
MIZORAM,2003,Service (Private),5,0,5
MIZORAM,2003,Public Sector Undertaking,0,0,0
MIZORAM,2003,Student,1,0,1
MIZORAM,2003,Unemployed,9,0,9
MIZORAM,2003,Self-employed (Business activity),3,0,3
MIZORAM,2003,Professional Activity,0,0,0
MIZORAM,2003,Farming/Agriculture Activity,0,0,0
MIZORAM,2003,Others (Please Specify),15,10,25
MIZORAM,2003,Retired Person,0,0,0
MIZORAM,2003,Others (Please Specify),4,1,5
MIZORAM,2003,Total,41,11,52
MIZORAM,2003,Total Salaried,9,0,9
MIZORAM,2003,Total Self-employed,18,10,28
MIZORAM,2004,House Wife,0,0,0
MIZORAM,2004,Service (Government),4,0,4
MIZORAM,2004,Service (Private),0,0,0
MIZORAM,2004,Public Sector Undertaking,5,0,5
MIZORAM,2004,Student,1,0,1
MIZORAM,2004,Unemployed,18,3,21
MIZORAM,2004,Self-employed (Business activity),0,0,0
MIZORAM,2004,Professional Activity,0,0,0
MIZORAM,2004,Farming/Agriculture Activity,2,0,2
MIZORAM,2004,Others (Please Specify),15,3,18
MIZORAM,2004,Retired Person,0,0,0
MIZORAM,2004,Others (Please Specify),8,1,9
MIZORAM,2004,Total,53,7,60
MIZORAM,2004,Total Salaried,9,0,9
MIZORAM,2004,Total Self-employed,17,3,20
MIZORAM,2005,House Wife,0,3,3
MIZORAM,2005,Service (Government),4,0,4
MIZORAM,2005,Service (Private),1,0,1
MIZORAM,2005,Public Sector Undertaking,0,0,0
MIZORAM,2005,Student,0,0,0
MIZORAM,2005,Unemployed,13,2,15
MIZORAM,2005,Self-employed (Business activity),0,0,0
MIZORAM,2005,Professional Activity,0,0,0
MIZORAM,2005,Farming/Agriculture Activity,0,0,0
MIZORAM,2005,Others (Please Specify),3,1,4
MIZORAM,2005,Retired Person,0,0,0
MIZORAM,2005,Others (Please Specify),26,2,28
MIZORAM,2005,Total,47,8,55
MIZORAM,2005,Total Salaried,5,0,5
MIZORAM,2005,Total Self-employed,3,1,4
MIZORAM,2006,House Wife,0,4,4
MIZORAM,2006,Service (Government),5,0,5
MIZORAM,2006,Service (Private),3,0,3
MIZORAM,2006,Public Sector Undertaking,3,0,3
MIZORAM,2006,Student,4,0,4
MIZORAM,2006,Unemployed,6,0,6
MIZORAM,2006,Self-employed (Business activity),0,0,0
MIZORAM,2006,Professional Activity,0,0,0
MIZORAM,2006,Farming/Agriculture Activity,1,0,1
MIZORAM,2006,Others (Please Specify),5,0,5
MIZORAM,2006,Retired Person,0,0,0
MIZORAM,2006,Others (Please Specify),33,6,39
MIZORAM,2006,Total,60,10,70
MIZORAM,2006,Total Salaried,11,0,11
MIZORAM,2006,Total Self-employed,6,0,6
MIZORAM,2007,House Wife,0,3,3
MIZORAM,2007,Service (Government),0,0,0
MIZORAM,2007,Service (Private),0,0,0
MIZORAM,2007,Public Sector Undertaking,0,0,0
MIZORAM,2007,Student,0,0,0
MIZORAM,2007,Unemployed,0,0,0
MIZORAM,2007,Self-employed (Business activity),0,0,0
MIZORAM,2007,Professional Activity,0,0,0
MIZORAM,2007,Farming/Agriculture Activity,0,0,0
MIZORAM,2007,Others (Please Specify),0,0,0
MIZORAM,2007,Retired Person,0,0,0
MIZORAM,2007,Others (Please Specify),22,3,25
MIZORAM,2007,Total,22,6,28
MIZORAM,2007,Total Salaried,0,0,0
MIZORAM,2007,Total Self-employed,0,0,0
MIZORAM,2008,House Wife,0,0,0
MIZORAM,2008,Service (Government),0,0,0
MIZORAM,2008,Service (Private),0,0,0
MIZORAM,2008,Public Sector Undertaking,0,0,0
MIZORAM,2008,Student,3,2,5
MIZORAM,2008,Unemployed,0,0,0
MIZORAM,2008,Self-employed (Business activity),3,0,3
MIZORAM,2008,Professional Activity,0,0,0
MIZORAM,2008,Farming/Agriculture Activity,0,0,0
MIZORAM,2008,Others (Please Specify),1,1,2
MIZORAM,2008,Retired Person,0,0,0
MIZORAM,2008,Others (Please Specify),28,3,31
MIZORAM,2008,Total,35,6,41
MIZORAM,2008,Total Salaried,0,0,0
MIZORAM,2008,Total Self-employed,4,1,5
MIZORAM,2009,House Wife,0,1,1
MIZORAM,2009,Service (Government),1,0,1
MIZORAM,2009,Service (Private),2,0,2
MIZORAM,2009,Public Sector Undertaking,0,0,0
MIZORAM,2009,Student,1,0,1
MIZORAM,2009,Unemployed,6,0,6
MIZORAM,2009,Self-employed (Business activity),0,0,0
MIZORAM,2009,Professional Activity,0,0,0
MIZORAM,2009,Farming/Agriculture Activity,33,5,38
MIZORAM,2009,Others (Please Specify),12,1,13
MIZORAM,2009,Retired Person,1,0,1
MIZORAM,2009,Others (Please Specify),6,0,6
MIZORAM,2009,Total,62,7,69
MIZORAM,2009,Total Salaried,3,0,3
MIZORAM,2009,Total Self-employed,45,6,51
MIZORAM,2010,House Wife,0,0,0
MIZORAM,2010,Service (Government),23,4,27
MIZORAM,2010,Service (Private),2,1,3
MIZORAM,2010,Public Sector Undertaking,0,0,0
MIZORAM,2010,Student,2,0,2
MIZORAM,2010,Unemployed,19,2,21
MIZORAM,2010,Self-employed (Business activity),0,0,0
MIZORAM,2010,Professional Activity,0,0,0
MIZORAM,2010,Farming/Agriculture Activity,5,0,5
MIZORAM,2010,Others (Please Specify),0,0,0
MIZORAM,2010,Retired Person,0,0,0
MIZORAM,2010,Others (Please Specify),16,2,18
MIZORAM,2010,Total,67,9,76
MIZORAM,2010,Total Salaried,25,5,30
MIZORAM,2010,Total Self-employed,5,0,5
MIZORAM,2011,House Wife,0,6,6
MIZORAM,2011,Service (Government),4,0,4
MIZORAM,2011,Service (Private),3,0,3
MIZORAM,2011,Public Sector Undertaking,0,1,1
MIZORAM,2011,Student,12,1,13
MIZORAM,2011,Unemployed,26,1,27
MIZORAM,2011,Self-employed (Business activity),0,0,0
MIZORAM,2011,Professional Activity,0,0,0
MIZORAM,2011,Farming/Agriculture Activity,13,1,14
MIZORAM,2011,Others (Please Specify),10,3,13
MIZORAM,2011,Retired Person,1,0,1
MIZORAM,2011,Others (Please Specify),8,0,8
MIZORAM,2011,Total,77,13,90
MIZORAM,2011,Total Salaried,7,1,8
MIZORAM,2011,Total Self-employed,23,4,27
MIZORAM,2012,House Wife,0,1,1
MIZORAM,2012,Service (Government),2,0,2
MIZORAM,2012,Service (Private),16,4,20
MIZORAM,2012,Public Sector Undertaking,0,0,0
MIZORAM,2012,Student,6,1,7
MIZORAM,2012,Unemployed,63,3,66
MIZORAM,2012,Self-employed (Business activity),39,0,39
MIZORAM,2012,Professional Activity,0,0,0
MIZORAM,2012,Farming/Agriculture Activity,9,1,10
MIZORAM,2012,Others (Please Specify),8,2,10
MIZORAM,2012,Retired Person,2,2,4
MIZORAM,2012,Others (Please Specify),12,2,14
MIZORAM,2012,Total,157,16,173
MIZORAM,2012,Total Salaried,18,4,22
MIZORAM,2012,Total Self-employed,56,3,59
NAGALAND,2001,House Wife,0,6,6
NAGALAND,2001,Service (Government),5,1,6
NAGALAND,2001,Service (Private),4,1,5
NAGALAND,2001,Public Sector Undertaking,0,0,0
NAGALAND,2001,Student,0,1,1
NAGALAND,2001,Unemployed,13,6,19
NAGALAND,2001,Self-employed (Business activity),2,0,2
NAGALAND,2001,Professional Activity,0,0,0
NAGALAND,2001,Farming/Agriculture Activity,0,0,0
NAGALAND,2001,Others (Please Specify),0,0,0
NAGALAND,2001,Retired Person,0,0,0
NAGALAND,2001,Others (Please Specify),1,0,1
NAGALAND,2001,Total,25,15,40
NAGALAND,2001,Total Salaried,9,2,11
NAGALAND,2001,Total Self-employed,2,0,2
NAGALAND,2002,House Wife,0,3,3
NAGALAND,2002,Service (Government),10,0,10
NAGALAND,2002,Service (Private),1,0,1
NAGALAND,2002,Public Sector Undertaking,0,0,0
NAGALAND,2002,Student,1,3,4
NAGALAND,2002,Unemployed,3,1,4
NAGALAND,2002,Self-employed (Business activity),1,0,1
NAGALAND,2002,Professional Activity,0,0,0
NAGALAND,2002,Farming/Agriculture Activity,0,0,0
NAGALAND,2002,Others (Please Specify),3,1,4
NAGALAND,2002,Retired Person,0,0,0
NAGALAND,2002,Others (Please Specify),0,0,0
NAGALAND,2002,Total,19,8,27
NAGALAND,2002,Total Salaried,11,0,11
NAGALAND,2002,Total Self-employed,4,1,5
NAGALAND,2003,House Wife,0,4,4
NAGALAND,2003,Service (Government),7,0,7
NAGALAND,2003,Service (Private),0,0,0
NAGALAND,2003,Public Sector Undertaking,0,0,0
NAGALAND,2003,Student,1,1,2
NAGALAND,2003,Unemployed,4,0,4
NAGALAND,2003,Self-employed (Business activity),1,0,1
NAGALAND,2003,Professional Activity,0,0,0
NAGALAND,2003,Farming/Agriculture Activity,0,0,0
NAGALAND,2003,Others (Please Specify),1,0,1
NAGALAND,2003,Retired Person,0,0,0
NAGALAND,2003,Others (Please Specify),3,0,3
NAGALAND,2003,Total,17,5,22
NAGALAND,2003,Total Salaried,7,0,7
NAGALAND,2003,Total Self-employed,2,0,2
NAGALAND,2004,House Wife,0,0,0
NAGALAND,2004,Service (Government),6,0,6
NAGALAND,2004,Service (Private),0,0,0
NAGALAND,2004,Public Sector Undertaking,2,0,2
NAGALAND,2004,Student,1,0,1
NAGALAND,2004,Unemployed,5,0,5
NAGALAND,2004,Self-employed (Business activity),0,0,0
NAGALAND,2004,Professional Activity,0,0,0
NAGALAND,2004,Farming/Agriculture Activity,0,0,0
NAGALAND,2004,Others (Please Specify),11,6,17
NAGALAND,2004,Retired Person,0,0,0
NAGALAND,2004,Others (Please Specify),0,0,0
NAGALAND,2004,Total,25,6,31
NAGALAND,2004,Total Salaried,8,0,8
NAGALAND,2004,Total Self-employed,11,6,17
NAGALAND,2005,House Wife,0,1,1
NAGALAND,2005,Service (Government),9,1,10
NAGALAND,2005,Service (Private),0,0,0
NAGALAND,2005,Public Sector Undertaking,0,0,0
NAGALAND,2005,Student,3,2,5
NAGALAND,2005,Unemployed,1,0,1
NAGALAND,2005,Self-employed (Business activity),1,0,1
NAGALAND,2005,Professional Activity,1,0,1
NAGALAND,2005,Farming/Agriculture Activity,0,0,0
NAGALAND,2005,Others (Please Specify),6,2,8
NAGALAND,2005,Retired Person,0,0,0
NAGALAND,2005,Others (Please Specify),0,0,0
NAGALAND,2005,Total,21,6,27
NAGALAND,2005,Total Salaried,9,1,10
NAGALAND,2005,Total Self-employed,8,2,10
NAGALAND,2006,House Wife,0,5,5
NAGALAND,2006,Service (Government),5,0,5
NAGALAND,2006,Service (Private),0,0,0
NAGALAND,2006,Public Sector Undertaking,0,0,0
NAGALAND,2006,Student,2,0,2
NAGALAND,2006,Unemployed,7,0,7
NAGALAND,2006,Self-employed (Business activity),1,0,1
NAGALAND,2006,Professional Activity,0,0,0
NAGALAND,2006,Farming/Agriculture Activity,1,1,2
NAGALAND,2006,Others (Please Specify),3,2,5
NAGALAND,2006,Retired Person,0,0,0
NAGALAND,2006,Others (Please Specify),0,1,1
NAGALAND,2006,Total,19,9,28
NAGALAND,2006,Total Salaried,5,0,5
NAGALAND,2006,Total Self-employed,5,3,8
NAGALAND,2007,House Wife,0,5,5
NAGALAND,2007,Service (Government),5,0,5
NAGALAND,2007,Service (Private),0,0,0
NAGALAND,2007,Public Sector Undertaking,0,0,0
NAGALAND,2007,Student,0,0,0
NAGALAND,2007,Unemployed,2,0,2
NAGALAND,2007,Self-employed (Business activity),0,0,0
NAGALAND,2007,Professional Activity,0,0,0
NAGALAND,2007,Farming/Agriculture Activity,0,0,0
NAGALAND,2007,Others (Please Specify),4,1,5
NAGALAND,2007,Retired Person,0,0,0
NAGALAND,2007,Others (Please Specify),6,1,7
NAGALAND,2007,Total,17,7,24
NAGALAND,2007,Total Salaried,5,0,5
NAGALAND,2007,Total Self-employed,4,1,5
NAGALAND,2008,House Wife,0,4,4
NAGALAND,2008,Service (Government),4,1,5
NAGALAND,2008,Service (Private),0,0,0
NAGALAND,2008,Public Sector Undertaking,0,0,0
NAGALAND,2008,Student,0,3,3
NAGALAND,2008,Unemployed,0,0,0
NAGALAND,2008,Self-employed (Business activity),0,0,0
NAGALAND,2008,Professional Activity,0,0,0
NAGALAND,2008,Farming/Agriculture Activity,2,0,2
NAGALAND,2008,Others (Please Specify),10,0,10
NAGALAND,2008,Retired Person,0,0,0
NAGALAND,2008,Others (Please Specify),16,2,18
NAGALAND,2008,Total,32,10,42
NAGALAND,2008,Total Salaried,4,1,5
NAGALAND,2008,Total Self-employed,12,0,12
NAGALAND,2009,House Wife,0,2,2
NAGALAND,2009,Service (Government),5,0,5
NAGALAND,2009,Service (Private),0,0,0
NAGALAND,2009,Public Sector Undertaking,0,0,0
NAGALAND,2009,Student,2,0,2
NAGALAND,2009,Unemployed,0,0,0
NAGALAND,2009,Self-employed (Business activity),1,0,1
NAGALAND,2009,Professional Activity,0,0,0
NAGALAND,2009,Farming/Agriculture Activity,0,1,1
NAGALAND,2009,Others (Please Specify),12,2,14
NAGALAND,2009,Retired Person,0,0,0
NAGALAND,2009,Others (Please Specify),5,1,6
NAGALAND,2009,Total,25,6,31
NAGALAND,2009,Total Salaried,5,0,5
NAGALAND,2009,Total Self-employed,13,3,16
NAGALAND,2010,House Wife,0,1,1
NAGALAND,2010,Service (Government),2,0,2
NAGALAND,2010,Service (Private),0,0,0
NAGALAND,2010,Public Sector Undertaking,0,0,0
NAGALAND,2010,Student,2,0,2
NAGALAND,2010,Unemployed,4,0,4
NAGALAND,2010,Self-employed (Business activity),0,0,0
NAGALAND,2010,Professional Activity,3,0,3
NAGALAND,2010,Farming/Agriculture Activity,0,0,0
NAGALAND,2010,Others (Please Specify),0,0,0
NAGALAND,2010,Retired Person,0,0,0
NAGALAND,2010,Others (Please Specify),0,0,0
NAGALAND,2010,Total,11,1,12
NAGALAND,2010,Total Salaried,2,0,2
NAGALAND,2010,Total Self-employed,3,0,3
NAGALAND,2011,House Wife,0,4,4
NAGALAND,2011,Service (Government),7,0,7
NAGALAND,2011,Service (Private),0,0,0
NAGALAND,2011,Public Sector Undertaking,0,0,0
NAGALAND,2011,Student,0,2,2
NAGALAND,2011,Unemployed,1,0,1
NAGALAND,2011,Self-employed (Business activity),1,0,1
NAGALAND,2011,Professional Activity,9,0,9
NAGALAND,2011,Farming/Agriculture Activity,2,0,2
NAGALAND,2011,Others (Please Specify),5,2,7
NAGALAND,2011,Retired Person,0,0,0
NAGALAND,2011,Others (Please Specify),0,0,0
NAGALAND,2011,Total,25,8,33
NAGALAND,2011,Total Salaried,7,0,7
NAGALAND,2011,Total Self-employed,17,2,19
NAGALAND,2012,House Wife,0,3,3
NAGALAND,2012,Service (Government),6,0,6
NAGALAND,2012,Service (Private),0,0,0
NAGALAND,2012,Public Sector Undertaking,0,0,0
NAGALAND,2012,Student,2,2,4
NAGALAND,2012,Unemployed,1,0,1
NAGALAND,2012,Self-employed (Business activity),3,0,3
NAGALAND,2012,Professional Activity,3,0,3
NAGALAND,2012,Farming/Agriculture Activity,8,1,9
NAGALAND,2012,Others (Please Specify),1,0,1
NAGALAND,2012,Retired Person,0,0,0
NAGALAND,2012,Others (Please Specify),0,0,0
NAGALAND,2012,Total,24,6,30
NAGALAND,2012,Total Salaried,6,0,6
NAGALAND,2012,Total Self-employed,15,1,16
ODISHA,2001,House Wife,0,840,840
ODISHA,2001,Service (Government),56,20,76
ODISHA,2001,Service (Private),150,83,233
ODISHA,2001,Public Sector Undertaking,41,34,75
ODISHA,2001,Student,144,124,268
ODISHA,2001,Unemployed,220,101,321
ODISHA,2001,Self-employed (Business activity),295,104,399
ODISHA,2001,Professional Activity,31,6,37
ODISHA,2001,Farming/Agriculture Activity,207,49,256
ODISHA,2001,Others (Please Specify),542,416,958
ODISHA,2001,Retired Person,26,2,28
ODISHA,2001,Others (Please Specify),377,184,561
ODISHA,2001,Total,2089,1963,4052
ODISHA,2001,Total Salaried,247,137,384
ODISHA,2001,Total Self-employed,1075,575,1650
ODISHA,2002,House Wife,0,770,770
ODISHA,2002,Service (Government),47,51,98
ODISHA,2002,Service (Private),343,51,394
ODISHA,2002,Public Sector Undertaking,124,40,164
ODISHA,2002,Student,159,120,279
ODISHA,2002,Unemployed,352,159,511
ODISHA,2002,Self-employed (Business activity),173,11,184
ODISHA,2002,Professional Activity,56,4,60
ODISHA,2002,Farming/Agriculture Activity,309,36,345
ODISHA,2002,Others (Please Specify),718,372,1090
ODISHA,2002,Retired Person,14,6,20
ODISHA,2002,Others (Please Specify),336,137,473
ODISHA,2002,Total,2631,1757,4388
ODISHA,2002,Total Salaried,514,142,656
ODISHA,2002,Total Self-employed,1256,423,1679
ODISHA,2003,House Wife,0,647,647
ODISHA,2003,Service (Government),62,91,153
ODISHA,2003,Service (Private),377,84,461
ODISHA,2003,Public Sector Undertaking,106,14,120
ODISHA,2003,Student,147,112,259
ODISHA,2003,Unemployed,297,132,429
ODISHA,2003,Self-employed (Business activity),184,30,214
ODISHA,2003,Professional Activity,55,22,77
ODISHA,2003,Farming/Agriculture Activity,324,41,365
ODISHA,2003,Others (Please Specify),774,299,1073
ODISHA,2003,Retired Person,41,9,50
ODISHA,2003,Others (Please Specify),373,199,572
ODISHA,2003,Total,2740,1680,4420
ODISHA,2003,Total Salaried,545,189,734
ODISHA,2003,Total Self-employed,1337,392,1729
ODISHA,2004,House Wife,0,620,620
ODISHA,2004,Service (Government),35,6,41
ODISHA,2004,Service (Private),162,59,221
ODISHA,2004,Public Sector Undertaking,70,21,91
ODISHA,2004,Student,145,121,266
ODISHA,2004,Unemployed,247,104,351
ODISHA,2004,Self-employed (Business activity),251,20,271
ODISHA,2004,Professional Activity,61,11,72
ODISHA,2004,Farming/Agriculture Activity,299,80,379
ODISHA,2004,Others (Please Specify),891,450,1341
ODISHA,2004,Retired Person,30,7,37
ODISHA,2004,Others (Please Specify),353,172,525
ODISHA,2004,Total,2544,1671,4215
ODISHA,2004,Total Salaried,267,86,353
ODISHA,2004,Total Self-employed,1502,561,2063
ODISHA,2005,House Wife,0,587,587
ODISHA,2005,Service (Government),54,26,80
ODISHA,2005,Service (Private),88,88,176
ODISHA,2005,Public Sector Undertaking,89,23,112
ODISHA,2005,Student,149,113,262
ODISHA,2005,Unemployed,278,110,388
ODISHA,2005,Self-employed (Business activity),320,42,362
ODISHA,2005,Professional Activity,80,25,105
ODISHA,2005,Farming/Agriculture Activity,204,50,254
ODISHA,2005,Others (Please Specify),892,364,1256
ODISHA,2005,Retired Person,10,2,12
ODISHA,2005,Others (Please Specify),390,224,614
ODISHA,2005,Total,2554,1654,4208
ODISHA,2005,Total Salaried,231,137,368
ODISHA,2005,Total Self-employed,1496,481,1977
ODISHA,2006,House Wife,0,531,531
ODISHA,2006,Service (Government),18,5,23
ODISHA,2006,Service (Private),133,92,225
ODISHA,2006,Public Sector Undertaking,32,17,49
ODISHA,2006,Student,112,159,271
ODISHA,2006,Unemployed,307,100,407
ODISHA,2006,Self-employed (Business activity),258,34,292
ODISHA,2006,Professional Activity,83,17,100
ODISHA,2006,Farming/Agriculture Activity,241,42,283
ODISHA,2006,Others (Please Specify),752,435,1187
ODISHA,2006,Retired Person,18,1,19
ODISHA,2006,Others (Please Specify),419,259,678
ODISHA,2006,Total,2373,1692,4065
ODISHA,2006,Total Salaried,183,114,297
ODISHA,2006,Total Self-employed,1334,528,1862
ODISHA,2007,House Wife,0,614,614
ODISHA,2007,Service (Government),26,6,32
ODISHA,2007,Service (Private),214,89,303
ODISHA,2007,Public Sector Undertaking,112,28,140
ODISHA,2007,Student,135,99,234
ODISHA,2007,Unemployed,224,177,401
ODISHA,2007,Self-employed (Business activity),336,12,348
ODISHA,2007,Professional Activity,82,25,107
ODISHA,2007,Farming/Agriculture Activity,170,70,240
ODISHA,2007,Others (Please Specify),684,392,1076
ODISHA,2007,Retired Person,31,5,36
ODISHA,2007,Others (Please Specify),474,303,777
ODISHA,2007,Total,2488,1820,4308
ODISHA,2007,Total Salaried,352,123,475
ODISHA,2007,Total Self-employed,1272,499,1771
ODISHA,2008,House Wife,0,679,679
ODISHA,2008,Service (Government),9,13,22
ODISHA,2008,Service (Private),272,87,359
ODISHA,2008,Public Sector Undertaking,108,28,136
ODISHA,2008,Student,131,86,217
ODISHA,2008,Unemployed,450,110,560
ODISHA,2008,Self-employed (Business activity),275,13,288
ODISHA,2008,Professional Activity,131,18,149
ODISHA,2008,Farming/Agriculture Activity,245,15,260
ODISHA,2008,Others (Please Specify),981,360,1341
ODISHA,2008,Retired Person,36,7,43
ODISHA,2008,Others (Please Specify),517,333,850
ODISHA,2008,Total,3155,1749,4904
ODISHA,2008,Total Salaried,389,128,517
ODISHA,2008,Total Self-employed,1632,406,2038
ODISHA,2009,House Wife,0,627,627
ODISHA,2009,Service (Government),33,11,44
ODISHA,2009,Service (Private),238,101,339
ODISHA,2009,Public Sector Undertaking,119,56,175
ODISHA,2009,Student,161,132,293
ODISHA,2009,Unemployed,374,114,488
ODISHA,2009,Self-employed (Business activity),255,19,274
ODISHA,2009,Professional Activity,37,11,48
ODISHA,2009,Farming/Agriculture Activity,143,11,154
ODISHA,2009,Others (Please Specify),787,551,1338
ODISHA,2009,Retired Person,45,12,57
ODISHA,2009,Others (Please Specify),375,153,528
ODISHA,2009,Total,2567,1798,4365
ODISHA,2009,Total Salaried,390,168,558
ODISHA,2009,Total Self-employed,1222,592,1814
ODISHA,2010,House Wife,0,730,730
ODISHA,2010,Service (Government),11,4,15
ODISHA,2010,Service (Private),269,63,332
ODISHA,2010,Public Sector Undertaking,110,35,145
ODISHA,2010,Student,173,128,301
ODISHA,2010,Unemployed,294,90,384
ODISHA,2010,Self-employed (Business activity),244,19,263
ODISHA,2010,Professional Activity,74,9,83
ODISHA,2010,Farming/Agriculture Activity,145,17,162
ODISHA,2010,Others (Please Specify),762,502,1264
ODISHA,2010,Retired Person,24,3,27
ODISHA,2010,Others (Please Specify),324,225,549
ODISHA,2010,Total,2430,1825,4255
ODISHA,2010,Total Salaried,390,102,492
ODISHA,2010,Total Self-employed,1225,547,1772
ODISHA,2011,House Wife,0,829,829
ODISHA,2011,Service (Government),34,8,42
ODISHA,2011,Service (Private),334,95,429
ODISHA,2011,Public Sector Undertaking,143,33,176
ODISHA,2011,Student,208,160,368
ODISHA,2011,Unemployed,381,149,530
ODISHA,2011,Self-employed (Business activity),275,49,324
ODISHA,2011,Professional Activity,112,9,121
ODISHA,2011,Farming/Agriculture Activity,138,6,144
ODISHA,2011,Others (Please Specify),1054,542,1596
ODISHA,2011,Retired Person,35,10,45
ODISHA,2011,Others (Please Specify),346,291,637
ODISHA,2011,Total,3060,2181,5241
ODISHA,2011,Total Salaried,511,136,647
ODISHA,2011,Total Self-employed,1579,606,2185
ODISHA,2012,House Wife,0,870,870
ODISHA,2012,Service (Government),28,36,64
ODISHA,2012,Service (Private),346,141,487
ODISHA,2012,Public Sector Undertaking,89,38,127
ODISHA,2012,Student,233,190,423
ODISHA,2012,Unemployed,424,130,554
ODISHA,2012,Self-employed (Business activity),377,39,416
ODISHA,2012,Professional Activity,150,13,163
ODISHA,2012,Farming/Agriculture Activity,121,25,146
ODISHA,2012,Others (Please Specify),538,334,872
ODISHA,2012,Retired Person,45,15,60
ODISHA,2012,Others (Please Specify),545,300,845
ODISHA,2012,Total,2896,2131,5027
ODISHA,2012,Total Salaried,463,215,678
ODISHA,2012,Total Self-employed,1186,411,1597
PUNJAB,2001,House Wife,0,98,98
PUNJAB,2001,Service (Government),14,3,17
PUNJAB,2001,Service (Private),32,6,38
PUNJAB,2001,Public Sector Undertaking,8,3,11
PUNJAB,2001,Student,5,3,8
PUNJAB,2001,Unemployed,61,10,71
PUNJAB,2001,Self-employed (Business activity),16,1,17
PUNJAB,2001,Professional Activity,7,0,7
PUNJAB,2001,Farming/Agriculture Activity,42,3,45
PUNJAB,2001,Others (Please Specify),25,3,28
PUNJAB,2001,Retired Person,6,0,6
PUNJAB,2001,Others (Please Specify),180,122,302
PUNJAB,2001,Total,396,252,648
PUNJAB,2001,Total Salaried,54,12,66
PUNJAB,2001,Total Self-employed,90,7,97
PUNJAB,2002,House Wife,0,87,87
PUNJAB,2002,Service (Government),19,0,19
PUNJAB,2002,Service (Private),23,1,24
PUNJAB,2002,Public Sector Undertaking,11,0,11
PUNJAB,2002,Student,11,8,19
PUNJAB,2002,Unemployed,41,4,45
PUNJAB,2002,Self-employed (Business activity),40,2,42
PUNJAB,2002,Professional Activity,22,0,22
PUNJAB,2002,Farming/Agriculture Activity,40,0,40
PUNJAB,2002,Others (Please Specify),110,2,112
PUNJAB,2002,Retired Person,3,0,3
PUNJAB,2002,Others (Please Specify),77,6,83
PUNJAB,2002,Total,397,110,507
PUNJAB,2002,Total Salaried,53,1,54
PUNJAB,2002,Total Self-employed,212,4,216
PUNJAB,2003,House Wife,0,74,74
PUNJAB,2003,Service (Government),10,2,12
PUNJAB,2003,Service (Private),34,5,39
PUNJAB,2003,Public Sector Undertaking,2,0,2
PUNJAB,2003,Student,14,9,23
PUNJAB,2003,Unemployed,55,3,58
PUNJAB,2003,Self-employed (Business activity),46,1,47
PUNJAB,2003,Professional Activity,2,0,2
PUNJAB,2003,Farming/Agriculture Activity,25,1,26
PUNJAB,2003,Others (Please Specify),119,4,123
PUNJAB,2003,Retired Person,7,0,7
PUNJAB,2003,Others (Please Specify),192,26,218
PUNJAB,2003,Total,506,125,631
PUNJAB,2003,Total Salaried,46,7,53
PUNJAB,2003,Total Self-employed,192,6,198
PUNJAB,2004,House Wife,0,62,62
PUNJAB,2004,Service (Government),16,0,16
PUNJAB,2004,Service (Private),31,10,41
PUNJAB,2004,Public Sector Undertaking,18,3,21
PUNJAB,2004,Student,9,17,26
PUNJAB,2004,Unemployed,46,10,56
PUNJAB,2004,Self-employed (Business activity),28,0,28
PUNJAB,2004,Professional Activity,26,0,26
PUNJAB,2004,Farming/Agriculture Activity,73,1,74
PUNJAB,2004,Others (Please Specify),152,4,156
PUNJAB,2004,Retired Person,8,0,8
PUNJAB,2004,Others (Please Specify),109,22,131
PUNJAB,2004,Total,516,129,645
PUNJAB,2004,Total Salaried,65,13,78
PUNJAB,2004,Total Self-employed,279,5,284
PUNJAB,2005,House Wife,0,77,77
PUNJAB,2005,Service (Government),15,1,16
PUNJAB,2005,Service (Private),35,0,35
PUNJAB,2005,Public Sector Undertaking,2,0,2
PUNJAB,2005,Student,17,4,21
PUNJAB,2005,Unemployed,47,5,52
PUNJAB,2005,Self-employed (Business activity),58,5,63
PUNJAB,2005,Professional Activity,14,0,14
PUNJAB,2005,Farming/Agriculture Activity,47,0,47
PUNJAB,2005,Others (Please Specify),148,3,151
PUNJAB,2005,Retired Person,8,0,8
PUNJAB,2005,Others (Please Specify),91,11,102
PUNJAB,2005,Total,482,106,588
PUNJAB,2005,Total Salaried,52,1,53
PUNJAB,2005,Total Self-employed,267,8,275
PUNJAB,2006,House Wife,0,110,110
PUNJAB,2006,Service (Government),16,0,16
PUNJAB,2006,Service (Private),56,4,60
PUNJAB,2006,Public Sector Undertaking,5,1,6
PUNJAB,2006,Student,18,13,31
PUNJAB,2006,Unemployed,66,2,68
PUNJAB,2006,Self-employed (Business activity),23,0,23
PUNJAB,2006,Professional Activity,47,0,47
PUNJAB,2006,Farming/Agriculture Activity,85,0,85
PUNJAB,2006,Others (Please Specify),121,9,130
PUNJAB,2006,Retired Person,1,0,1
PUNJAB,2006,Others (Please Specify),172,23,195
PUNJAB,2006,Total,610,162,772
PUNJAB,2006,Total Salaried,77,5,82
PUNJAB,2006,Total Self-employed,276,9,285
PUNJAB,2007,House Wife,0,132,132
PUNJAB,2007,Service (Government),27,3,30
PUNJAB,2007,Service (Private),63,3,66
PUNJAB,2007,Public Sector Undertaking,0,0,0
PUNJAB,2007,Student,15,15,30
PUNJAB,2007,Unemployed,42,9,51
PUNJAB,2007,Self-employed (Business activity),42,0,42
PUNJAB,2007,Professional Activity,23,1,24
PUNJAB,2007,Farming/Agriculture Activity,86,2,88
PUNJAB,2007,Others (Please Specify),170,14,184
PUNJAB,2007,Retired Person,6,0,6
PUNJAB,2007,Others (Please Specify),158,36,194
PUNJAB,2007,Total,632,215,847
PUNJAB,2007,Total Salaried,90,6,96
PUNJAB,2007,Total Self-employed,321,17,338
PUNJAB,2008,House Wife,0,156,156
PUNJAB,2008,Service (Government),29,0,29
PUNJAB,2008,Service (Private),83,5,88
PUNJAB,2008,Public Sector Undertaking,2,0,2
PUNJAB,2008,Student,26,22,48
PUNJAB,2008,Unemployed,54,1,55
PUNJAB,2008,Self-employed (Business activity),105,0,105
PUNJAB,2008,Professional Activity,13,0,13
PUNJAB,2008,Farming/Agriculture Activity,66,0,66
PUNJAB,2008,Others (Please Specify),124,31,155
PUNJAB,2008,Retired Person,2,0,2
PUNJAB,2008,Others (Please Specify),139,11,150
PUNJAB,2008,Total,643,226,869
PUNJAB,2008,Total Salaried,114,5,119
PUNJAB,2008,Total Self-employed,308,31,339
PUNJAB,2009,House Wife,0,130,130
PUNJAB,2009,Service (Government),15,0,15
PUNJAB,2009,Service (Private),54,7,61
PUNJAB,2009,Public Sector Undertaking,6,2,8
PUNJAB,2009,Student,29,26,55
PUNJAB,2009,Unemployed,43,5,48
PUNJAB,2009,Self-employed (Business activity),51,2,53
PUNJAB,2009,Professional Activity,31,1,32
PUNJAB,2009,Farming/Agriculture Activity,93,4,97
PUNJAB,2009,Others (Please Specify),176,9,185
PUNJAB,2009,Retired Person,12,8,20
PUNJAB,2009,Others (Please Specify),125,18,143
PUNJAB,2009,Total,635,212,847
PUNJAB,2009,Total Salaried,75,9,84
PUNJAB,2009,Total Self-employed,351,16,367
PUNJAB,2010,House Wife,0,130,130
PUNJAB,2010,Service (Government),21,2,23
PUNJAB,2010,Service (Private),82,1,83
PUNJAB,2010,Public Sector Undertaking,0,0,0
PUNJAB,2010,Student,31,24,55
PUNJAB,2010,Unemployed,59,8,67
PUNJAB,2010,Self-employed (Business activity),41,0,41
PUNJAB,2010,Professional Activity,21,0,21
PUNJAB,2010,Farming/Agriculture Activity,80,0,80
PUNJAB,2010,Others (Please Specify),239,14,253
PUNJAB,2010,Retired Person,8,0,8
PUNJAB,2010,Others (Please Specify),137,22,159
PUNJAB,2010,Total,719,201,920
PUNJAB,2010,Total Salaried,103,3,106
PUNJAB,2010,Total Self-employed,381,14,395
PUNJAB,2011,House Wife,0,148,148
PUNJAB,2011,Service (Government),43,0,43
PUNJAB,2011,Service (Private),148,6,154
PUNJAB,2011,Public Sector Undertaking,8,8,16
PUNJAB,2011,Student,21,17,38
PUNJAB,2011,Unemployed,94,6,100
PUNJAB,2011,Self-employed (Business activity),31,0,31
PUNJAB,2011,Professional Activity,17,0,17
PUNJAB,2011,Farming/Agriculture Activity,94,4,98
PUNJAB,2011,Others (Please Specify),144,12,156
PUNJAB,2011,Retired Person,9,0,9
PUNJAB,2011,Others (Please Specify),146,10,156
PUNJAB,2011,Total,755,211,966
PUNJAB,2011,Total Salaried,199,14,213
PUNJAB,2011,Total Self-employed,286,16,302
PUNJAB,2012,House Wife,0,173,173
PUNJAB,2012,Service (Government),13,1,14
PUNJAB,2012,Service (Private),169,12,181
PUNJAB,2012,Public Sector Undertaking,13,4,17
PUNJAB,2012,Student,30,27,57
PUNJAB,2012,Unemployed,83,7,90
PUNJAB,2012,Self-employed (Business activity),39,0,39
PUNJAB,2012,Professional Activity,25,0,25
PUNJAB,2012,Farming/Agriculture Activity,75,0,75
PUNJAB,2012,Others (Please Specify),243,13,256
PUNJAB,2012,Retired Person,7,1,8
PUNJAB,2012,Others (Please Specify),87,8,95
PUNJAB,2012,Total,784,246,1030
PUNJAB,2012,Total Salaried,195,17,212
PUNJAB,2012,Total Self-employed,382,13,395
RAJASTHAN,2001,House Wife,0,783,783
RAJASTHAN,2001,Service (Government),59,3,62
RAJASTHAN,2001,Service (Private),218,27,245
RAJASTHAN,2001,Public Sector Undertaking,72,11,83
RAJASTHAN,2001,Student,121,83,204
RAJASTHAN,2001,Unemployed,179,21,200
RAJASTHAN,2001,Self-employed (Business activity),143,11,154
RAJASTHAN,2001,Professional Activity,40,0,40
RAJASTHAN,2001,Farming/Agriculture Activity,424,81,505
RAJASTHAN,2001,Others (Please Specify),381,131,512
RAJASTHAN,2001,Retired Person,8,0,8
RAJASTHAN,2001,Others (Please Specify),314,85,399
RAJASTHAN,2001,Total,1959,1236,3195
RAJASTHAN,2001,Total Salaried,349,41,390
RAJASTHAN,2001,Total Self-employed,988,223,1211
RAJASTHAN,2002,House Wife,0,767,767
RAJASTHAN,2002,Service (Government),62,2,64
RAJASTHAN,2002,Service (Private),221,30,251
RAJASTHAN,2002,Public Sector Undertaking,59,8,67
RAJASTHAN,2002,Student,87,52,139
RAJASTHAN,2002,Unemployed,128,16,144
RAJASTHAN,2002,Self-employed (Business activity),120,5,125
RAJASTHAN,2002,Professional Activity,25,1,26
RAJASTHAN,2002,Farming/Agriculture Activity,493,94,587
RAJASTHAN,2002,Others (Please Specify),443,91,534
RAJASTHAN,2002,Retired Person,17,2,19
RAJASTHAN,2002,Others (Please Specify),437,88,525
RAJASTHAN,2002,Total,2092,1156,3248
RAJASTHAN,2002,Total Salaried,342,40,382
RAJASTHAN,2002,Total Self-employed,1081,191,1272
RAJASTHAN,2003,House Wife,0,938,938
RAJASTHAN,2003,Service (Government),42,3,45
RAJASTHAN,2003,Service (Private),258,27,285
RAJASTHAN,2003,Public Sector Undertaking,73,18,91
RAJASTHAN,2003,Student,138,67,205
RAJASTHAN,2003,Unemployed,158,3,161
RAJASTHAN,2003,Self-employed (Business activity),140,0,140
RAJASTHAN,2003,Professional Activity,46,0,46
RAJASTHAN,2003,Farming/Agriculture Activity,562,74,636
RAJASTHAN,2003,Others (Please Specify),599,73,672
RAJASTHAN,2003,Retired Person,18,0,18
RAJASTHAN,2003,Others (Please Specify),355,69,424
RAJASTHAN,2003,Total,2389,1272,3661
RAJASTHAN,2003,Total Salaried,373,48,421
RAJASTHAN,2003,Total Self-employed,1347,147,1494
RAJASTHAN,2004,House Wife,0,868,868
RAJASTHAN,2004,Service (Government),24,2,26
RAJASTHAN,2004,Service (Private),278,24,302
RAJASTHAN,2004,Public Sector Undertaking,37,4,41
RAJASTHAN,2004,Student,98,49,147
RAJASTHAN,2004,Unemployed,182,5,187
RAJASTHAN,2004,Self-employed (Business activity),109,4,113
RAJASTHAN,2004,Professional Activity,32,0,32
RAJASTHAN,2004,Farming/Agriculture Activity,675,74,749
RAJASTHAN,2004,Others (Please Specify),471,84,555
RAJASTHAN,2004,Retired Person,2,0,2
RAJASTHAN,2004,Others (Please Specify),578,125,703
RAJASTHAN,2004,Total,2486,1239,3725
RAJASTHAN,2004,Total Salaried,339,30,369
RAJASTHAN,2004,Total Self-employed,1287,162,1449
RAJASTHAN,2005,House Wife,0,1100,1100
RAJASTHAN,2005,Service (Government),38,0,38
RAJASTHAN,2005,Service (Private),275,11,286
RAJASTHAN,2005,Public Sector Undertaking,30,4,34
RAJASTHAN,2005,Student,75,37,112
RAJASTHAN,2005,Unemployed,100,2,102
RAJASTHAN,2005,Self-employed (Business activity),120,0,120
RAJASTHAN,2005,Professional Activity,27,0,27
RAJASTHAN,2005,Farming/Agriculture Activity,436,25,461
RAJASTHAN,2005,Others (Please Specify),538,49,587
RAJASTHAN,2005,Retired Person,4,0,4
RAJASTHAN,2005,Others (Please Specify),1215,92,1307
RAJASTHAN,2005,Total,2858,1320,4178
RAJASTHAN,2005,Total Salaried,343,15,358
RAJASTHAN,2005,Total Self-employed,1121,74,1195
RAJASTHAN,2006,House Wife,0,1093,1093
RAJASTHAN,2006,Service (Government),40,0,40
RAJASTHAN,2006,Service (Private),338,11,349
RAJASTHAN,2006,Public Sector Undertaking,29,4,33
RAJASTHAN,2006,Student,70,64,134
RAJASTHAN,2006,Unemployed,97,0,97
RAJASTHAN,2006,Self-employed (Business activity),171,5,176
RAJASTHAN,2006,Professional Activity,19,0,19
RAJASTHAN,2006,Farming/Agriculture Activity,356,39,395
RAJASTHAN,2006,Others (Please Specify),705,55,760
RAJASTHAN,2006,Retired Person,2,1,3
RAJASTHAN,2006,Others (Please Specify),1083,81,1164
RAJASTHAN,2006,Total,2910,1353,4263
RAJASTHAN,2006,Total Salaried,407,15,422
RAJASTHAN,2006,Total Self-employed,1251,99,1350
RAJASTHAN,2007,House Wife,0,1023,1023
RAJASTHAN,2007,Service (Government),39,29,68
RAJASTHAN,2007,Service (Private),341,10,351
RAJASTHAN,2007,Public Sector Undertaking,24,5,29
RAJASTHAN,2007,Student,115,70,185
RAJASTHAN,2007,Unemployed,157,5,162
RAJASTHAN,2007,Self-employed (Business activity),279,0,279
RAJASTHAN,2007,Professional Activity,36,3,39
RAJASTHAN,2007,Farming/Agriculture Activity,589,29,618
RAJASTHAN,2007,Others (Please Specify),757,41,798
RAJASTHAN,2007,Retired Person,0,0,0
RAJASTHAN,2007,Others (Please Specify),817,68,885
RAJASTHAN,2007,Total,3154,1283,4437
RAJASTHAN,2007,Total Salaried,404,44,448
RAJASTHAN,2007,Total Self-employed,1661,73,1734
RAJASTHAN,2008,House Wife,0,958,958
RAJASTHAN,2008,Service (Government),63,26,89
RAJASTHAN,2008,Service (Private),431,35,466
RAJASTHAN,2008,Public Sector Undertaking,17,2,19
RAJASTHAN,2008,Student,173,69,242
RAJASTHAN,2008,Unemployed,176,31,207
RAJASTHAN,2008,Self-employed (Business activity),234,10,244
RAJASTHAN,2008,Professional Activity,53,0,53
RAJASTHAN,2008,Farming/Agriculture Activity,695,101,796
RAJASTHAN,2008,Others (Please Specify),972,164,1136
RAJASTHAN,2008,Retired Person,13,0,13
RAJASTHAN,2008,Others (Please Specify),775,168,943
RAJASTHAN,2008,Total,3602,1564,5166
RAJASTHAN,2008,Total Salaried,511,63,574
RAJASTHAN,2008,Total Self-employed,1954,275,2229
RAJASTHAN,2009,House Wife,0,1070,1070
RAJASTHAN,2009,Service (Government),36,10,46
RAJASTHAN,2009,Service (Private),522,14,536
RAJASTHAN,2009,Public Sector Undertaking,20,3,23
RAJASTHAN,2009,Student,146,77,223
RAJASTHAN,2009,Unemployed,139,17,156
RAJASTHAN,2009,Self-employed (Business activity),277,6,283
RAJASTHAN,2009,Professional Activity,52,1,53
RAJASTHAN,2009,Farming/Agriculture Activity,775,76,851
RAJASTHAN,2009,Others (Please Specify),902,146,1048
RAJASTHAN,2009,Retired Person,5,1,6
RAJASTHAN,2009,Others (Please Specify),637,133,770
RAJASTHAN,2009,Total,3511,1554,5065
RAJASTHAN,2009,Total Salaried,578,27,605
RAJASTHAN,2009,Total Self-employed,2006,229,2235
RAJASTHAN,2010,House Wife,0,1034,1034
RAJASTHAN,2010,Service (Government),36,6,42
RAJASTHAN,2010,Service (Private),403,28,431
RAJASTHAN,2010,Public Sector Undertaking,34,6,40
RAJASTHAN,2010,Student,144,89,233
RAJASTHAN,2010,Unemployed,172,27,199
RAJASTHAN,2010,Self-employed (Business activity),176,5,181
RAJASTHAN,2010,Professional Activity,61,4,65
RAJASTHAN,2010,Farming/Agriculture Activity,351,39,390
RAJASTHAN,2010,Others (Please Specify),916,95,1011
RAJASTHAN,2010,Retired Person,35,6,41
RAJASTHAN,2010,Others (Please Specify),1037,216,1253
RAJASTHAN,2010,Total,3365,1555,4920
RAJASTHAN,2010,Total Salaried,473,40,513
RAJASTHAN,2010,Total Self-employed,1504,143,1647
RAJASTHAN,2011,House Wife,0,784,784
RAJASTHAN,2011,Service (Government),35,8,43
RAJASTHAN,2011,Service (Private),413,45,458
RAJASTHAN,2011,Public Sector Undertaking,25,5,30
RAJASTHAN,2011,Student,157,79,236
RAJASTHAN,2011,Unemployed,114,14,128
RAJASTHAN,2011,Self-employed (Business activity),161,14,175
RAJASTHAN,2011,Professional Activity,104,1,105
RAJASTHAN,2011,Farming/Agriculture Activity,224,44,268
RAJASTHAN,2011,Others (Please Specify),738,111,849
RAJASTHAN,2011,Retired Person,8,0,8
RAJASTHAN,2011,Others (Please Specify),1037,227,1264
RAJASTHAN,2011,Total,3016,1332,4348
RAJASTHAN,2011,Total Salaried,473,58,531
RAJASTHAN,2011,Total Self-employed,1227,170,1397
RAJASTHAN,2012,House Wife,0,894,894
RAJASTHAN,2012,Service (Government),48,5,53
RAJASTHAN,2012,Service (Private),370,28,398
RAJASTHAN,2012,Public Sector Undertaking,41,3,44
RAJASTHAN,2012,Student,138,102,240
RAJASTHAN,2012,Unemployed,132,43,175
RAJASTHAN,2012,Self-employed (Business activity),165,13,178
RAJASTHAN,2012,Professional Activity,96,1,97
RAJASTHAN,2012,Farming/Agriculture Activity,242,28,270
RAJASTHAN,2012,Others (Please Specify),698,78,776
RAJASTHAN,2012,Retired Person,11,0,11
RAJASTHAN,2012,Others (Please Specify),1286,399,1685
RAJASTHAN,2012,Total,3227,1594,4821
RAJASTHAN,2012,Total Salaried,459,36,495
RAJASTHAN,2012,Total Self-employed,1201,120,1321
SIKKIM,2001,House Wife,0,12,12
SIKKIM,2001,Service (Government),2,3,5
SIKKIM,2001,Service (Private),7,0,7
SIKKIM,2001,Public Sector Undertaking,1,0,1
SIKKIM,2001,Student,1,4,5
SIKKIM,2001,Unemployed,8,4,12
SIKKIM,2001,Self-employed (Business activity),3,0,3
SIKKIM,2001,Professional Activity,8,7,15
SIKKIM,2001,Farming/Agriculture Activity,16,2,18
SIKKIM,2001,Others (Please Specify),16,0,16
SIKKIM,2001,Retired Person,0,0,0
SIKKIM,2001,Others (Please Specify),0,0,0
SIKKIM,2001,Total,62,32,94
SIKKIM,2001,Total Salaried,10,3,13
SIKKIM,2001,Total Self-employed,43,9,52
SIKKIM,2002,House Wife,0,1,1
SIKKIM,2002,Service (Government),0,0,0
SIKKIM,2002,Service (Private),0,0,0
SIKKIM,2002,Public Sector Undertaking,0,0,0
SIKKIM,2002,Student,3,2,5
SIKKIM,2002,Unemployed,10,12,22
SIKKIM,2002,Self-employed (Business activity),3,1,4
SIKKIM,2002,Professional Activity,0,0,0
SIKKIM,2002,Farming/Agriculture Activity,5,3,8
SIKKIM,2002,Others (Please Specify),19,4,23
SIKKIM,2002,Retired Person,3,0,3
SIKKIM,2002,Others (Please Specify),11,1,12
SIKKIM,2002,Total,54,24,78
SIKKIM,2002,Total Salaried,0,0,0
SIKKIM,2002,Total Self-employed,27,8,35
SIKKIM,2003,House Wife,0,21,21
SIKKIM,2003,Service (Government),6,3,9
SIKKIM,2003,Service (Private),13,0,13
SIKKIM,2003,Public Sector Undertaking,0,0,0
SIKKIM,2003,Student,9,1,10
SIKKIM,2003,Unemployed,12,1,13
SIKKIM,2003,Self-employed (Business activity),3,0,3
SIKKIM,2003,Professional Activity,0,0,0
SIKKIM,2003,Farming/Agriculture Activity,20,11,31
SIKKIM,2003,Others (Please Specify),5,0,5
SIKKIM,2003,Retired Person,0,0,0
SIKKIM,2003,Others (Please Specify),0,0,0
SIKKIM,2003,Total,68,37,105
SIKKIM,2003,Total Salaried,19,3,22
SIKKIM,2003,Total Self-employed,28,11,39
SIKKIM,2004,House Wife,0,11,11
SIKKIM,2004,Service (Government),3,0,3
SIKKIM,2004,Service (Private),6,0,6
SIKKIM,2004,Public Sector Undertaking,0,0,0
SIKKIM,2004,Student,0,0,0
SIKKIM,2004,Unemployed,2,4,6
SIKKIM,2004,Self-employed (Business activity),0,0,0
SIKKIM,2004,Professional Activity,6,2,8
SIKKIM,2004,Farming/Agriculture Activity,30,19,49
SIKKIM,2004,Others (Please Specify),5,5,10
SIKKIM,2004,Retired Person,0,0,0
SIKKIM,2004,Others (Please Specify),4,1,5
SIKKIM,2004,Total,56,42,98
SIKKIM,2004,Total Salaried,9,0,9
SIKKIM,2004,Total Self-employed,41,26,67
SIKKIM,2005,House Wife,0,20,20
SIKKIM,2005,Service (Government),2,0,2
SIKKIM,2005,Service (Private),2,3,5
SIKKIM,2005,Public Sector Undertaking,0,0,0
SIKKIM,2005,Student,5,5,10
SIKKIM,2005,Unemployed,4,0,4
SIKKIM,2005,Self-employed (Business activity),0,1,1
SIKKIM,2005,Professional Activity,0,0,0
SIKKIM,2005,Farming/Agriculture Activity,34,7,41
SIKKIM,2005,Others (Please Specify),11,6,17
SIKKIM,2005,Retired Person,0,0,0
SIKKIM,2005,Others (Please Specify),4,5,9
SIKKIM,2005,Total,62,47,109
SIKKIM,2005,Total Salaried,4,3,7
SIKKIM,2005,Total Self-employed,45,14,59
SIKKIM,2006,House Wife,0,15,15
SIKKIM,2006,Service (Government),4,0,4
SIKKIM,2006,Service (Private),13,1,14
SIKKIM,2006,Public Sector Undertaking,0,0,0
SIKKIM,2006,Student,24,15,39
SIKKIM,2006,Unemployed,18,0,18
SIKKIM,2006,Self-employed (Business activity),3,0,3
SIKKIM,2006,Professional Activity,0,0,0
SIKKIM,2006,Farming/Agriculture Activity,27,8,35
SIKKIM,2006,Others (Please Specify),9,8,17
SIKKIM,2006,Retired Person,0,0,0
SIKKIM,2006,Others (Please Specify),0,0,0
SIKKIM,2006,Total,98,47,145
SIKKIM,2006,Total Salaried,17,1,18
SIKKIM,2006,Total Self-employed,39,16,55
SIKKIM,2007,House Wife,0,6,6
SIKKIM,2007,Service (Government),0,0,0
SIKKIM,2007,Service (Private),9,3,12
SIKKIM,2007,Public Sector Undertaking,0,1,1
SIKKIM,2007,Student,5,0,5
SIKKIM,2007,Unemployed,9,2,11
SIKKIM,2007,Self-employed (Business activity),0,0,0
SIKKIM,2007,Professional Activity,0,0,0
SIKKIM,2007,Farming/Agriculture Activity,15,6,21
SIKKIM,2007,Others (Please Specify),30,7,37
SIKKIM,2007,Retired Person,0,0,0
SIKKIM,2007,Others (Please Specify),16,13,29
SIKKIM,2007,Total,84,38,122
SIKKIM,2007,Total Salaried,9,4,13
SIKKIM,2007,Total Self-employed,45,13,58
SIKKIM,2008,House Wife,0,7,7
SIKKIM,2008,Service (Government),0,0,0
SIKKIM,2008,Service (Private),20,8,28
SIKKIM,2008,Public Sector Undertaking,0,6,6
SIKKIM,2008,Student,8,4,12
SIKKIM,2008,Unemployed,36,13,49
SIKKIM,2008,Self-employed (Business activity),0,0,0
SIKKIM,2008,Professional Activity,0,0,0
SIKKIM,2008,Farming/Agriculture Activity,49,11,60
SIKKIM,2008,Others (Please Specify),60,0,60
SIKKIM,2008,Retired Person,0,0,0
SIKKIM,2008,Others (Please Specify),43,22,65
SIKKIM,2008,Total,216,71,287
SIKKIM,2008,Total Salaried,20,14,34
SIKKIM,2008,Total Self-employed,109,11,120
SIKKIM,2009,House Wife,0,8,8
SIKKIM,2009,Service (Government),7,5,12
SIKKIM,2009,Service (Private),13,18,31
SIKKIM,2009,Public Sector Undertaking,11,16,27
SIKKIM,2009,Student,5,2,7
SIKKIM,2009,Unemployed,12,23,35
SIKKIM,2009,Self-employed (Business activity),26,9,35
SIKKIM,2009,Professional Activity,9,14,23
SIKKIM,2009,Farming/Agriculture Activity,14,9,23
SIKKIM,2009,Others (Please Specify),8,5,13
SIKKIM,2009,Retired Person,4,3,7
SIKKIM,2009,Others (Please Specify),13,7,20
SIKKIM,2009,Total,122,119,241
SIKKIM,2009,Total Salaried,31,39,70
SIKKIM,2009,Total Self-employed,57,37,94
SIKKIM,2010,House Wife,0,5,5
SIKKIM,2010,Service (Government),29,6,35
SIKKIM,2010,Service (Private),52,3,55
SIKKIM,2010,Public Sector Undertaking,21,10,31
SIKKIM,2010,Student,2,1,3
SIKKIM,2010,Unemployed,45,7,52
SIKKIM,2010,Self-employed (Business activity),23,1,24
SIKKIM,2010,Professional Activity,21,1,22
SIKKIM,2010,Farming/Agriculture Activity,19,0,19
SIKKIM,2010,Others (Please Specify),7,1,8
SIKKIM,2010,Retired Person,3,2,5
SIKKIM,2010,Others (Please Specify),13,8,21
SIKKIM,2010,Total,235,45,280
SIKKIM,2010,Total Salaried,102,19,121
SIKKIM,2010,Total Self-employed,70,3,73
SIKKIM,2011,House Wife,0,12,12
SIKKIM,2011,Service (Government),12,2,14
SIKKIM,2011,Service (Private),20,11,31
SIKKIM,2011,Public Sector Undertaking,14,4,18
SIKKIM,2011,Student,3,4,7
SIKKIM,2011,Unemployed,17,9,26
SIKKIM,2011,Self-employed (Business activity),6,5,11
SIKKIM,2011,Professional Activity,1,4,5
SIKKIM,2011,Farming/Agriculture Activity,7,5,12
SIKKIM,2011,Others (Please Specify),10,10,20
SIKKIM,2011,Retired Person,2,0,2
SIKKIM,2011,Others (Please Specify),15,11,26
SIKKIM,2011,Total,107,77,184
SIKKIM,2011,Total Salaried,46,17,63
SIKKIM,2011,Total Self-employed,24,24,48
SIKKIM,2012,House Wife,0,22,22
SIKKIM,2012,Service (Government),17,6,23
SIKKIM,2012,Service (Private),14,8,22
SIKKIM,2012,Public Sector Undertaking,8,2,10
SIKKIM,2012,Student,7,13,20
SIKKIM,2012,Unemployed,5,14,19
SIKKIM,2012,Self-employed (Business activity),15,0,15
SIKKIM,2012,Professional Activity,11,0,11
SIKKIM,2012,Farming/Agriculture Activity,10,9,19
SIKKIM,2012,Others (Please Specify),9,11,20
SIKKIM,2012,Retired Person,0,0,0
SIKKIM,2012,Others (Please Specify),0,0,0
SIKKIM,2012,Total,96,85,181
SIKKIM,2012,Total Salaried,39,16,55
SIKKIM,2012,Total Self-employed,45,20,65
TAMIL NADU,2001,House Wife,0,1755,1755
TAMIL NADU,2001,Service (Government),166,67,233
TAMIL NADU,2001,Service (Private),850,234,1084
TAMIL NADU,2001,Public Sector Undertaking,207,98,305
TAMIL NADU,2001,Student,236,168,404
TAMIL NADU,2001,Unemployed,1330,528,1858
TAMIL NADU,2001,Self-employed (Business activity),656,57,713
TAMIL NADU,2001,Professional Activity,294,64,358
TAMIL NADU,2001,Farming/Agriculture Activity,826,159,985
TAMIL NADU,2001,Others (Please Specify),1466,573,2039
TAMIL NADU,2001,Retired Person,44,6,50
TAMIL NADU,2001,Others (Please Specify),1053,453,1506
TAMIL NADU,2001,Total,7128,4162,11290
TAMIL NADU,2001,Total Salaried,1223,399,1622
TAMIL NADU,2001,Total Self-employed,3242,853,4095
TAMIL NADU,2002,House Wife,0,2138,2138
TAMIL NADU,2002,Service (Government),224,127,351
TAMIL NADU,2002,Service (Private),828,287,1115
TAMIL NADU,2002,Public Sector Undertaking,230,96,326
TAMIL NADU,2002,Student,259,215,474
TAMIL NADU,2002,Unemployed,1066,296,1362
TAMIL NADU,2002,Self-employed (Business activity),775,61,836
TAMIL NADU,2002,Professional Activity,127,18,145
TAMIL NADU,2002,Farming/Agriculture Activity,1257,198,1455
TAMIL NADU,2002,Others (Please Specify),1200,446,1646
TAMIL NADU,2002,Retired Person,35,19,54
TAMIL NADU,2002,Others (Please Specify),982,360,1342
TAMIL NADU,2002,Total,6983,4261,11244
TAMIL NADU,2002,Total Salaried,1282,510,1792
TAMIL NADU,2002,Total Self-employed,3359,723,4082
TAMIL NADU,2003,House Wife,0,2068,2068
TAMIL NADU,2003,Service (Government),189,77,266
TAMIL NADU,2003,Service (Private),794,437,1231
TAMIL NADU,2003,Public Sector Undertaking,308,101,409
TAMIL NADU,2003,Student,247,219,466
TAMIL NADU,2003,Unemployed,1468,506,1974
TAMIL NADU,2003,Self-employed (Business activity),700,106,806
TAMIL NADU,2003,Professional Activity,417,79,496
TAMIL NADU,2003,Farming/Agriculture Activity,832,220,1052
TAMIL NADU,2003,Others (Please Specify),1382,377,1759
TAMIL NADU,2003,Retired Person,67,17,84
TAMIL NADU,2003,Others (Please Specify),750,511,1261
TAMIL NADU,2003,Total,7154,4718,11872
TAMIL NADU,2003,Total Salaried,1291,615,1906
TAMIL NADU,2003,Total Self-employed,3331,782,4113
TAMIL NADU,2004,House Wife,0,2112,2112
TAMIL NADU,2004,Service (Government),155,44,199
TAMIL NADU,2004,Service (Private),832,251,1083
TAMIL NADU,2004,Public Sector Undertaking,227,73,300
TAMIL NADU,2004,Student,247,226,473
TAMIL NADU,2004,Unemployed,1241,458,1699
TAMIL NADU,2004,Self-employed (Business activity),812,58,870
TAMIL NADU,2004,Professional Activity,275,57,332
TAMIL NADU,2004,Farming/Agriculture Activity,1297,302,1599
TAMIL NADU,2004,Others (Please Specify),1426,570,1996
TAMIL NADU,2004,Retired Person,89,17,106
TAMIL NADU,2004,Others (Please Specify),1345,725,2070
TAMIL NADU,2004,Total,7946,4893,12839
TAMIL NADU,2004,Total Salaried,1214,368,1582
TAMIL NADU,2004,Total Self-employed,3810,987,4797
TAMIL NADU,2005,House Wife,0,2058,2058
TAMIL NADU,2005,Service (Government),159,32,191
TAMIL NADU,2005,Service (Private),947,249,1196
TAMIL NADU,2005,Public Sector Undertaking,205,75,280
TAMIL NADU,2005,Student,261,270,531
TAMIL NADU,2005,Unemployed,1174,511,1685
TAMIL NADU,2005,Self-employed (Business activity),793,125,918
TAMIL NADU,2005,Professional Activity,246,40,286
TAMIL NADU,2005,Farming/Agriculture Activity,1002,253,1255
TAMIL NADU,2005,Others (Please Specify),1430,481,1911
TAMIL NADU,2005,Retired Person,94,8,102
TAMIL NADU,2005,Others (Please Specify),1196,467,1663
TAMIL NADU,2005,Total,7507,4569,12076
TAMIL NADU,2005,Total Salaried,1311,356,1667
TAMIL NADU,2005,Total Self-employed,3471,899,4370
TAMIL NADU,2006,House Wife,0,2354,2354
TAMIL NADU,2006,Service (Government),155,30,185
TAMIL NADU,2006,Service (Private),1092,628,1720
TAMIL NADU,2006,Public Sector Undertaking,245,86,331
TAMIL NADU,2006,Student,99,127,226
TAMIL NADU,2006,Unemployed,746,481,1227
TAMIL NADU,2006,Self-employed (Business activity),1118,87,1205
TAMIL NADU,2006,Professional Activity,0,0,0
TAMIL NADU,2006,Farming/Agriculture Activity,342,84,426
TAMIL NADU,2006,Others (Please Specify),2560,581,3141
TAMIL NADU,2006,Retired Person,87,15,102
TAMIL NADU,2006,Others (Please Specify),1065,399,1464
TAMIL NADU,2006,Total,7509,4872,12381
TAMIL NADU,2006,Total Salaried,1492,744,2236
TAMIL NADU,2006,Total Self-employed,4020,752,4772
TAMIL NADU,2007,House Wife,0,2476,2476
TAMIL NADU,2007,Service (Government),179,32,211
TAMIL NADU,2007,Service (Private),1263,660,1923
TAMIL NADU,2007,Public Sector Undertaking,283,90,373
TAMIL NADU,2007,Student,115,134,249
TAMIL NADU,2007,Unemployed,863,506,1369
TAMIL NADU,2007,Self-employed (Business activity),1293,92,1385
TAMIL NADU,2007,Professional Activity,0,0,0
TAMIL NADU,2007,Farming/Agriculture Activity,396,88,484
TAMIL NADU,2007,Others (Please Specify),2962,611,3573
TAMIL NADU,2007,Retired Person,101,16,117
TAMIL NADU,2007,Others (Please Specify),1232,419,1651
TAMIL NADU,2007,Total,8687,5124,13811
TAMIL NADU,2007,Total Salaried,1725,782,2507
TAMIL NADU,2007,Total Self-employed,4651,791,5442
TAMIL NADU,2008,House Wife,0,2430,2430
TAMIL NADU,2008,Service (Government),269,46,315
TAMIL NADU,2008,Service (Private),1333,688,2021
TAMIL NADU,2008,Public Sector Undertaking,281,107,388
TAMIL NADU,2008,Student,114,144,258
TAMIL NADU,2008,Unemployed,873,493,1366
TAMIL NADU,2008,Self-employed (Business activity),1286,141,1427
TAMIL NADU,2008,Professional Activity,416,142,558
TAMIL NADU,2008,Farming/Agriculture Activity,400,112,512
TAMIL NADU,2008,Others (Please Specify),2771,640,3411
TAMIL NADU,2008,Retired Person,101,16,117
TAMIL NADU,2008,Others (Please Specify),1199,423,1622
TAMIL NADU,2008,Total,9043,5382,14425
TAMIL NADU,2008,Total Salaried,1883,841,2724
TAMIL NADU,2008,Total Self-employed,4873,1035,5908
TAMIL NADU,2009,House Wife,0,2763,2763
TAMIL NADU,2009,Service (Government),208,45,253
TAMIL NADU,2009,Service (Private),1359,380,1739
TAMIL NADU,2009,Public Sector Undertaking,345,27,372
TAMIL NADU,2009,Student,257,199,456
TAMIL NADU,2009,Unemployed,1562,424,1986
TAMIL NADU,2009,Self-employed (Business activity),709,122,831
TAMIL NADU,2009,Professional Activity,242,86,328
TAMIL NADU,2009,Farming/Agriculture Activity,856,204,1060
TAMIL NADU,2009,Others (Please Specify),1833,569,2402
TAMIL NADU,2009,Retired Person,182,32,214
TAMIL NADU,2009,Others (Please Specify),1397,623,2020
TAMIL NADU,2009,Total,8950,5474,14424
TAMIL NADU,2009,Total Salaried,1912,452,2364
TAMIL NADU,2009,Total Self-employed,3640,981,4621
TAMIL NADU,2010,House Wife,0,2667,2667
TAMIL NADU,2010,Service (Government),122,58,180
TAMIL NADU,2010,Service (Private),1430,305,1735
TAMIL NADU,2010,Public Sector Undertaking,264,77,341
TAMIL NADU,2010,Student,359,278,637
TAMIL NADU,2010,Unemployed,1527,545,2072
TAMIL NADU,2010,Self-employed (Business activity),861,219,1080
TAMIL NADU,2010,Professional Activity,212,51,263
TAMIL NADU,2010,Farming/Agriculture Activity,442,99,541
TAMIL NADU,2010,Others (Please Specify),1950,767,2717
TAMIL NADU,2010,Retired Person,112,20,132
TAMIL NADU,2010,Others (Please Specify),3273,923,4196
TAMIL NADU,2010,Total,10552,6009,16561
TAMIL NADU,2010,Total Salaried,1816,440,2256
TAMIL NADU,2010,Total Self-employed,3465,1136,4601
TAMIL NADU,2011,House Wife,0,2433,2433
TAMIL NADU,2011,Service (Government),120,37,157
TAMIL NADU,2011,Service (Private),1038,227,1265
TAMIL NADU,2011,Public Sector Undertaking,130,51,181
TAMIL NADU,2011,Student,480,369,849
TAMIL NADU,2011,Unemployed,1763,471,2234
TAMIL NADU,2011,Self-employed (Business activity),729,49,778
TAMIL NADU,2011,Professional Activity,327,94,421
TAMIL NADU,2011,Farming/Agriculture Activity,482,141,623
TAMIL NADU,2011,Others (Please Specify),1964,510,2474
TAMIL NADU,2011,Retired Person,81,9,90
TAMIL NADU,2011,Others (Please Specify),3168,1290,4458
TAMIL NADU,2011,Total,10282,5681,15963
TAMIL NADU,2011,Total Salaried,1288,315,1603
TAMIL NADU,2011,Total Self-employed,3502,794,4296
TAMIL NADU,2012,House Wife,0,2911,2911
TAMIL NADU,2012,Service (Government),237,47,284
TAMIL NADU,2012,Service (Private),861,186,1047
TAMIL NADU,2012,Public Sector Undertaking,191,67,258
TAMIL NADU,2012,Student,387,408,795
TAMIL NADU,2012,Unemployed,1517,421,1938
TAMIL NADU,2012,Self-employed (Business activity),730,71,801
TAMIL NADU,2012,Professional Activity,145,75,220
TAMIL NADU,2012,Farming/Agriculture Activity,409,90,499
TAMIL NADU,2012,Others (Please Specify),2446,586,3032
TAMIL NADU,2012,Retired Person,62,9,71
TAMIL NADU,2012,Others (Please Specify),3763,1308,5071
TAMIL NADU,2012,Total,10748,6179,16927
TAMIL NADU,2012,Total Salaried,1289,300,1589
TAMIL NADU,2012,Total Self-employed,3730,822,4552
TRIPURA,2001,House Wife,0,71,71
TRIPURA,2001,Service (Government),0,0,0
TRIPURA,2001,Service (Private),13,2,15
TRIPURA,2001,Public Sector Undertaking,0,3,3
TRIPURA,2001,Student,37,33,70
TRIPURA,2001,Unemployed,40,14,54
TRIPURA,2001,Self-employed (Business activity),49,2,51
TRIPURA,2001,Professional Activity,9,4,13
TRIPURA,2001,Farming/Agriculture Activity,41,0,41
TRIPURA,2001,Others (Please Specify),50,19,69
TRIPURA,2001,Retired Person,0,0,0
TRIPURA,2001,Others (Please Specify),224,243,467
TRIPURA,2001,Total,463,391,854
TRIPURA,2001,Total Salaried,13,5,18
TRIPURA,2001,Total Self-employed,149,25,174
TRIPURA,2002,House Wife,0,104,104
TRIPURA,2002,Service (Government),23,11,34
TRIPURA,2002,Service (Private),23,12,35
TRIPURA,2002,Public Sector Undertaking,23,9,32
TRIPURA,2002,Student,19,19,38
TRIPURA,2002,Unemployed,53,5,58
TRIPURA,2002,Self-employed (Business activity),46,0,46
TRIPURA,2002,Professional Activity,40,0,40
TRIPURA,2002,Farming/Agriculture Activity,27,14,41
TRIPURA,2002,Others (Please Specify),111,25,136
TRIPURA,2002,Retired Person,4,0,4
TRIPURA,2002,Others (Please Specify),124,87,211
TRIPURA,2002,Total,493,286,779
TRIPURA,2002,Total Salaried,69,32,101
TRIPURA,2002,Total Self-employed,224,39,263
TRIPURA,2003,House Wife,0,120,120
TRIPURA,2003,Service (Government),19,9,28
TRIPURA,2003,Service (Private),23,4,27
TRIPURA,2003,Public Sector Undertaking,35,10,45
TRIPURA,2003,Student,157,73,230
TRIPURA,2003,Unemployed,208,102,310
TRIPURA,2003,Self-employed (Business activity),7,9,16
TRIPURA,2003,Professional Activity,1,6,7
TRIPURA,2003,Farming/Agriculture Activity,0,4,4
TRIPURA,2003,Others (Please Specify),22,8,30
TRIPURA,2003,Retired Person,4,4,8
TRIPURA,2003,Others (Please Specify),12,7,19
TRIPURA,2003,Total,488,356,844
TRIPURA,2003,Total Salaried,77,23,100
TRIPURA,2003,Total Self-employed,30,27,57
TRIPURA,2004,House Wife,0,152,152
TRIPURA,2004,Service (Government),8,3,11
TRIPURA,2004,Service (Private),11,3,14
TRIPURA,2004,Public Sector Undertaking,4,0,4
TRIPURA,2004,Student,46,64,110
TRIPURA,2004,Unemployed,174,82,256
TRIPURA,2004,Self-employed (Business activity),31,2,33
TRIPURA,2004,Professional Activity,31,0,31
TRIPURA,2004,Farming/Agriculture Activity,15,0,15
TRIPURA,2004,Others (Please Specify),46,13,59
TRIPURA,2004,Retired Person,0,0,0
TRIPURA,2004,Others (Please Specify),67,18,85
TRIPURA,2004,Total,433,337,770
TRIPURA,2004,Total Salaried,23,6,29
TRIPURA,2004,Total Self-employed,123,15,138
TRIPURA,2005,House Wife,0,104,104
TRIPURA,2005,Service (Government),23,10,33
TRIPURA,2005,Service (Private),34,14,48
TRIPURA,2005,Public Sector Undertaking,22,12,34
TRIPURA,2005,Student,29,40,69
TRIPURA,2005,Unemployed,72,18,90
TRIPURA,2005,Self-employed (Business activity),62,0,62
TRIPURA,2005,Professional Activity,41,0,41
TRIPURA,2005,Farming/Agriculture Activity,29,0,29
TRIPURA,2005,Others (Please Specify),40,57,97
TRIPURA,2005,Retired Person,14,0,14
TRIPURA,2005,Others (Please Specify),35,59,94
TRIPURA,2005,Total,401,314,715
TRIPURA,2005,Total Salaried,79,36,115
TRIPURA,2005,Total Self-employed,172,57,229
TRIPURA,2006,House Wife,0,133,133
TRIPURA,2006,Service (Government),10,0,10
TRIPURA,2006,Service (Private),7,0,7
TRIPURA,2006,Public Sector Undertaking,6,0,6
TRIPURA,2006,Student,43,41,84
TRIPURA,2006,Unemployed,45,17,62
TRIPURA,2006,Self-employed (Business activity),18,0,18
TRIPURA,2006,Professional Activity,7,0,7
TRIPURA,2006,Farming/Agriculture Activity,7,0,7
TRIPURA,2006,Others (Please Specify),47,6,53
TRIPURA,2006,Retired Person,0,0,0
TRIPURA,2006,Others (Please Specify),238,140,378
TRIPURA,2006,Total,428,337,765
TRIPURA,2006,Total Salaried,23,0,23
TRIPURA,2006,Total Self-employed,79,6,85
TRIPURA,2007,House Wife,0,93,93
TRIPURA,2007,Service (Government),28,5,33
TRIPURA,2007,Service (Private),8,0,8
TRIPURA,2007,Public Sector Undertaking,0,0,0
TRIPURA,2007,Student,36,34,70
TRIPURA,2007,Unemployed,41,3,44
TRIPURA,2007,Self-employed (Business activity),63,0,63
TRIPURA,2007,Professional Activity,0,0,0
TRIPURA,2007,Farming/Agriculture Activity,0,0,0
TRIPURA,2007,Others (Please Specify),167,101,268
TRIPURA,2007,Retired Person,2,0,2
TRIPURA,2007,Others (Please Specify),74,50,124
TRIPURA,2007,Total,419,286,705
TRIPURA,2007,Total Salaried,36,5,41
TRIPURA,2007,Total Self-employed,230,101,331
TRIPURA,2008,House Wife,0,130,130
TRIPURA,2008,Service (Government),15,0,15
TRIPURA,2008,Service (Private),14,11,25
TRIPURA,2008,Public Sector Undertaking,2,0,2
TRIPURA,2008,Student,52,39,91
TRIPURA,2008,Unemployed,133,18,151
TRIPURA,2008,Self-employed (Business activity),18,0,18
TRIPURA,2008,Professional Activity,0,0,0
TRIPURA,2008,Farming/Agriculture Activity,45,5,50
TRIPURA,2008,Others (Please Specify),92,34,126
TRIPURA,2008,Retired Person,0,0,0
TRIPURA,2008,Others (Please Specify),71,73,144
TRIPURA,2008,Total,442,310,752
TRIPURA,2008,Total Salaried,31,11,42
TRIPURA,2008,Total Self-employed,155,39,194
TRIPURA,2009,House Wife,0,176,176
TRIPURA,2009,Service (Government),19,0,19
TRIPURA,2009,Service (Private),19,0,19
TRIPURA,2009,Public Sector Undertaking,2,0,2
TRIPURA,2009,Student,47,42,89
TRIPURA,2009,Unemployed,25,4,29
TRIPURA,2009,Self-employed (Business activity),71,4,75
TRIPURA,2009,Professional Activity,20,0,20
TRIPURA,2009,Farming/Agriculture Activity,45,0,45
TRIPURA,2009,Others (Please Specify),168,35,203
TRIPURA,2009,Retired Person,0,0,0
TRIPURA,2009,Others (Please Specify),51,10,61
TRIPURA,2009,Total,467,271,738
TRIPURA,2009,Total Salaried,40,0,40
TRIPURA,2009,Total Self-employed,304,39,343
TRIPURA,2010,House Wife,0,194,194
TRIPURA,2010,Service (Government),18,1,19
TRIPURA,2010,Service (Private),30,0,30
TRIPURA,2010,Public Sector Undertaking,0,0,0
TRIPURA,2010,Student,74,32,106
TRIPURA,2010,Unemployed,35,6,41
TRIPURA,2010,Self-employed (Business activity),75,12,87
TRIPURA,2010,Professional Activity,30,0,30
TRIPURA,2010,Farming/Agriculture Activity,46,12,58
TRIPURA,2010,Others (Please Specify),122,27,149
TRIPURA,2010,Retired Person,11,0,11
TRIPURA,2010,Others (Please Specify),0,0,0
TRIPURA,2010,Total,441,284,725
TRIPURA,2010,Total Salaried,48,1,49
TRIPURA,2010,Total Self-employed,273,51,324
TRIPURA,2011,House Wife,0,140,140
TRIPURA,2011,Service (Government),3,0,3
TRIPURA,2011,Service (Private),20,0,20
TRIPURA,2011,Public Sector Undertaking,0,0,0
TRIPURA,2011,Student,80,82,162
TRIPURA,2011,Unemployed,2,0,2
TRIPURA,2011,Self-employed (Business activity),99,0,99
TRIPURA,2011,Professional Activity,0,0,0
TRIPURA,2011,Farming/Agriculture Activity,20,0,20
TRIPURA,2011,Others (Please Specify),29,7,36
TRIPURA,2011,Retired Person,0,0,0
TRIPURA,2011,Others (Please Specify),194,27,221
TRIPURA,2011,Total,447,256,703
TRIPURA,2011,Total Salaried,23,0,23
TRIPURA,2011,Total Self-employed,148,7,155
TRIPURA,2012,House Wife,0,128,128
TRIPURA,2012,Service (Government),2,0,2
TRIPURA,2012,Service (Private),6,0,6
TRIPURA,2012,Public Sector Undertaking,0,0,0
TRIPURA,2012,Student,45,31,76
TRIPURA,2012,Unemployed,25,3,28
TRIPURA,2012,Self-employed (Business activity),55,0,55
TRIPURA,2012,Professional Activity,6,0,6
TRIPURA,2012,Farming/Agriculture Activity,18,0,18
TRIPURA,2012,Others (Please Specify),135,23,158
TRIPURA,2012,Retired Person,0,0,0
TRIPURA,2012,Others (Please Specify),268,99,367
TRIPURA,2012,Total,560,284,844
TRIPURA,2012,Total Salaried,8,0,8
TRIPURA,2012,Total Self-employed,214,23,237
UTTAR PRADESH,2001,House Wife,0,1075,1075
UTTAR PRADESH,2001,Service (Government),31,26,57
UTTAR PRADESH,2001,Service (Private),239,73,312
UTTAR PRADESH,2001,Public Sector Undertaking,39,7,46
UTTAR PRADESH,2001,Student,123,88,211
UTTAR PRADESH,2001,Unemployed,316,20,336
UTTAR PRADESH,2001,Self-employed (Business activity),131,8,139
UTTAR PRADESH,2001,Professional Activity,37,4,41
UTTAR PRADESH,2001,Farming/Agriculture Activity,578,110,688
UTTAR PRADESH,2001,Others (Please Specify),199,241,440
UTTAR PRADESH,2001,Retired Person,5,6,11
UTTAR PRADESH,2001,Others (Please Specify),103,57,160
UTTAR PRADESH,2001,Total,1801,1715,3516
UTTAR PRADESH,2001,Total Salaried,309,106,415
UTTAR PRADESH,2001,Total Self-employed,945,363,1308
UTTAR PRADESH,2002,House Wife,0,1103,1103
UTTAR PRADESH,2002,Service (Government),21,9,30
UTTAR PRADESH,2002,Service (Private),200,27,227
UTTAR PRADESH,2002,Public Sector Undertaking,32,4,36
UTTAR PRADESH,2002,Student,120,96,216
UTTAR PRADESH,2002,Unemployed,452,33,485
UTTAR PRADESH,2002,Self-employed (Business activity),130,7,137
UTTAR PRADESH,2002,Professional Activity,29,6,35
UTTAR PRADESH,2002,Farming/Agriculture Activity,471,54,525
UTTAR PRADESH,2002,Others (Please Specify),545,468,1013
UTTAR PRADESH,2002,Retired Person,13,1,14
UTTAR PRADESH,2002,Others (Please Specify),313,116,429
UTTAR PRADESH,2002,Total,2326,1924,4250
UTTAR PRADESH,2002,Total Salaried,253,40,293
UTTAR PRADESH,2002,Total Self-employed,1175,535,1710
UTTAR PRADESH,2003,House Wife,0,1073,1073
UTTAR PRADESH,2003,Service (Government),43,17,60
UTTAR PRADESH,2003,Service (Private),173,75,248
UTTAR PRADESH,2003,Public Sector Undertaking,57,5,62
UTTAR PRADESH,2003,Student,118,98,216
UTTAR PRADESH,2003,Unemployed,392,62,454
UTTAR PRADESH,2003,Self-employed (Business activity),144,19,163
UTTAR PRADESH,2003,Professional Activity,106,11,117
UTTAR PRADESH,2003,Farming/Agriculture Activity,341,46,387
UTTAR PRADESH,2003,Others (Please Specify),338,146,484
UTTAR PRADESH,2003,Retired Person,29,9,38
UTTAR PRADESH,2003,Others (Please Specify),246,115,361
UTTAR PRADESH,2003,Total,1987,1676,3663
UTTAR PRADESH,2003,Total Salaried,273,97,370
UTTAR PRADESH,2003,Total Self-employed,929,222,1151
UTTAR PRADESH,2004,House Wife,0,1090,1090
UTTAR PRADESH,2004,Service (Government),30,2,32
UTTAR PRADESH,2004,Service (Private),155,73,228
UTTAR PRADESH,2004,Public Sector Undertaking,83,37,120
UTTAR PRADESH,2004,Student,128,73,201
UTTAR PRADESH,2004,Unemployed,295,92,387
UTTAR PRADESH,2004,Self-employed (Business activity),117,10,127
UTTAR PRADESH,2004,Professional Activity,80,7,87
UTTAR PRADESH,2004,Farming/Agriculture Activity,401,95,496
UTTAR PRADESH,2004,Others (Please Specify),384,154,538
UTTAR PRADESH,2004,Retired Person,17,4,21
UTTAR PRADESH,2004,Others (Please Specify),264,46,310
UTTAR PRADESH,2004,Total,1954,1683,3637
UTTAR PRADESH,2004,Total Salaried,268,112,380
UTTAR PRADESH,2004,Total Self-employed,982,266,1248
UTTAR PRADESH,2005,House Wife,0,1014,1014
UTTAR PRADESH,2005,Service (Government),35,13,48
UTTAR PRADESH,2005,Service (Private),164,95,259
UTTAR PRADESH,2005,Public Sector Undertaking,72,52,124
UTTAR PRADESH,2005,Student,140,79,219
UTTAR PRADESH,2005,Unemployed,195,72,267
UTTAR PRADESH,2005,Self-employed (Business activity),220,8,228
UTTAR PRADESH,2005,Professional Activity,61,3,64
UTTAR PRADESH,2005,Farming/Agriculture Activity,422,100,522
UTTAR PRADESH,2005,Others (Please Specify),305,167,472
UTTAR PRADESH,2005,Retired Person,6,3,9
UTTAR PRADESH,2005,Others (Please Specify),152,71,223
UTTAR PRADESH,2005,Total,1772,1677,3449
UTTAR PRADESH,2005,Total Salaried,271,160,431
UTTAR PRADESH,2005,Total Self-employed,1008,278,1286
UTTAR PRADESH,2006,House Wife,0,710,710
UTTAR PRADESH,2006,Service (Government),115,32,147
UTTAR PRADESH,2006,Service (Private),155,58,213
UTTAR PRADESH,2006,Public Sector Undertaking,28,19,47
UTTAR PRADESH,2006,Student,102,69,171
UTTAR PRADESH,2006,Unemployed,201,40,241
UTTAR PRADESH,2006,Self-employed (Business activity),149,20,169
UTTAR PRADESH,2006,Professional Activity,70,17,87
UTTAR PRADESH,2006,Farming/Agriculture Activity,346,65,411
UTTAR PRADESH,2006,Others (Please Specify),346,198,544
UTTAR PRADESH,2006,Retired Person,7,0,7
UTTAR PRADESH,2006,Others (Please Specify),242,110,352
UTTAR PRADESH,2006,Total,1761,1338,3099
UTTAR PRADESH,2006,Total Salaried,298,109,407
UTTAR PRADESH,2006,Total Self-employed,911,300,1211
UTTAR PRADESH,2007,House Wife,0,974,974
UTTAR PRADESH,2007,Service (Government),39,14,53
UTTAR PRADESH,2007,Service (Private),191,43,234
UTTAR PRADESH,2007,Public Sector Undertaking,33,13,46
UTTAR PRADESH,2007,Student,148,126,274
UTTAR PRADESH,2007,Unemployed,317,50,367
UTTAR PRADESH,2007,Self-employed (Business activity),136,19,155
UTTAR PRADESH,2007,Professional Activity,89,13,102
UTTAR PRADESH,2007,Farming/Agriculture Activity,389,97,486
UTTAR PRADESH,2007,Others (Please Specify),513,336,849
UTTAR PRADESH,2007,Retired Person,5,1,6
UTTAR PRADESH,2007,Others (Please Specify),194,187,381
UTTAR PRADESH,2007,Total,2054,1873,3927
UTTAR PRADESH,2007,Total Salaried,263,70,333
UTTAR PRADESH,2007,Total Self-employed,1127,465,1592
UTTAR PRADESH,2008,House Wife,0,1105,1105
UTTAR PRADESH,2008,Service (Government),30,14,44
UTTAR PRADESH,2008,Service (Private),192,41,233
UTTAR PRADESH,2008,Public Sector Undertaking,43,11,54
UTTAR PRADESH,2008,Student,200,154,354
UTTAR PRADESH,2008,Unemployed,239,47,286
UTTAR PRADESH,2008,Self-employed (Business activity),181,22,203
UTTAR PRADESH,2008,Professional Activity,22,9,31
UTTAR PRADESH,2008,Farming/Agriculture Activity,616,129,745
UTTAR PRADESH,2008,Others (Please Specify),422,262,684
UTTAR PRADESH,2008,Retired Person,6,0,6
UTTAR PRADESH,2008,Others (Please Specify),228,115,343
UTTAR PRADESH,2008,Total,2179,1909,4088
UTTAR PRADESH,2008,Total Salaried,265,66,331
UTTAR PRADESH,2008,Total Self-employed,1241,422,1663
UTTAR PRADESH,2009,House Wife,0,1006,1006
UTTAR PRADESH,2009,Service (Government),31,18,49
UTTAR PRADESH,2009,Service (Private),261,86,347
UTTAR PRADESH,2009,Public Sector Undertaking,50,23,73
UTTAR PRADESH,2009,Student,203,143,346
UTTAR PRADESH,2009,Unemployed,319,52,371
UTTAR PRADESH,2009,Self-employed (Business activity),126,18,144
UTTAR PRADESH,2009,Professional Activity,21,2,23
UTTAR PRADESH,2009,Farming/Agriculture Activity,524,132,656
UTTAR PRADESH,2009,Others (Please Specify),485,297,782
UTTAR PRADESH,2009,Retired Person,4,11,15
UTTAR PRADESH,2009,Others (Please Specify),215,131,346
UTTAR PRADESH,2009,Total,2239,1919,4158
UTTAR PRADESH,2009,Total Salaried,342,127,469
UTTAR PRADESH,2009,Total Self-employed,1156,449,1605
UTTAR PRADESH,2010,House Wife,0,1005,1005
UTTAR PRADESH,2010,Service (Government),38,75,113
UTTAR PRADESH,2010,Service (Private),188,70,258
UTTAR PRADESH,2010,Public Sector Undertaking,16,6,22
UTTAR PRADESH,2010,Student,156,161,317
UTTAR PRADESH,2010,Unemployed,232,56,288
UTTAR PRADESH,2010,Self-employed (Business activity),184,7,191
UTTAR PRADESH,2010,Professional Activity,67,0,67
UTTAR PRADESH,2010,Farming/Agriculture Activity,432,116,548
UTTAR PRADESH,2010,Others (Please Specify),314,221,535
UTTAR PRADESH,2010,Retired Person,12,4,16
UTTAR PRADESH,2010,Others (Please Specify),148,120,268
UTTAR PRADESH,2010,Total,1787,1841,3628
UTTAR PRADESH,2010,Total Salaried,242,151,393
UTTAR PRADESH,2010,Total Self-employed,997,344,1341
UTTAR PRADESH,2011,House Wife,0,1244,1244
UTTAR PRADESH,2011,Service (Government),48,41,89
UTTAR PRADESH,2011,Service (Private),319,79,398
UTTAR PRADESH,2011,Public Sector Undertaking,16,4,20
UTTAR PRADESH,2011,Student,153,106,259
UTTAR PRADESH,2011,Unemployed,259,63,322
UTTAR PRADESH,2011,Self-employed (Business activity),105,27,132
UTTAR PRADESH,2011,Professional Activity,113,9,122
UTTAR PRADESH,2011,Farming/Agriculture Activity,553,92,645
UTTAR PRADESH,2011,Others (Please Specify),516,238,754
UTTAR PRADESH,2011,Retired Person,6,3,9
UTTAR PRADESH,2011,Others (Please Specify),625,224,849
UTTAR PRADESH,2011,Total,2713,2130,4843
UTTAR PRADESH,2011,Total Salaried,383,124,507
UTTAR PRADESH,2011,Total Self-employed,1287,366,1653
UTTAR PRADESH,2012,House Wife,0,1077,1077
UTTAR PRADESH,2012,Service (Government),62,27,89
UTTAR PRADESH,2012,Service (Private),325,145,470
UTTAR PRADESH,2012,Public Sector Undertaking,31,25,56
UTTAR PRADESH,2012,Student,154,151,305
UTTAR PRADESH,2012,Unemployed,209,37,246
UTTAR PRADESH,2012,Self-employed (Business activity),210,17,227
UTTAR PRADESH,2012,Professional Activity,125,5,130
UTTAR PRADESH,2012,Farming/Agriculture Activity,619,126,745
UTTAR PRADESH,2012,Others (Please Specify),282,165,447
UTTAR PRADESH,2012,Retired Person,8,2,10
UTTAR PRADESH,2012,Others (Please Specify),470,150,620
UTTAR PRADESH,2012,Total,2495,1927,4422
UTTAR PRADESH,2012,Total Salaried,418,197,615
UTTAR PRADESH,2012,Total Self-employed,1236,313,1549
UTTARAKHAND,2001,House Wife,0,64,64
UTTARAKHAND,2001,Service (Government),10,10,20
UTTARAKHAND,2001,Service (Private),65,17,82
UTTARAKHAND,2001,Public Sector Undertaking,2,0,2
UTTARAKHAND,2001,Student,12,9,21
UTTARAKHAND,2001,Unemployed,28,4,32
UTTARAKHAND,2001,Self-employed (Business activity),8,0,8
UTTARAKHAND,2001,Professional Activity,0,0,0
UTTARAKHAND,2001,Farming/Agriculture Activity,18,3,21
UTTARAKHAND,2001,Others (Please Specify),30,19,49
UTTARAKHAND,2001,Retired Person,2,0,2
UTTARAKHAND,2001,Others (Please Specify),7,3,10
UTTARAKHAND,2001,Total,182,129,311
UTTARAKHAND,2001,Total Salaried,77,27,104
UTTARAKHAND,2001,Total Self-employed,56,22,78
UTTARAKHAND,2002,House Wife,0,119,119
UTTARAKHAND,2002,Service (Government),5,2,7
UTTARAKHAND,2002,Service (Private),25,2,27
UTTARAKHAND,2002,Public Sector Undertaking,1,0,1
UTTARAKHAND,2002,Student,6,3,9
UTTARAKHAND,2002,Unemployed,38,7,45
UTTARAKHAND,2002,Self-employed (Business activity),8,0,8
UTTARAKHAND,2002,Professional Activity,4,0,4
UTTARAKHAND,2002,Farming/Agriculture Activity,31,3,34
UTTARAKHAND,2002,Others (Please Specify),75,20,95
UTTARAKHAND,2002,Retired Person,5,0,5
UTTARAKHAND,2002,Others (Please Specify),7,0,7
UTTARAKHAND,2002,Total,205,156,361
UTTARAKHAND,2002,Total Salaried,31,4,35
UTTARAKHAND,2002,Total Self-employed,118,23,141
UTTARAKHAND,2003,House Wife,0,81,81
UTTARAKHAND,2003,Service (Government),14,1,15
UTTARAKHAND,2003,Service (Private),60,15,75
UTTARAKHAND,2003,Public Sector Undertaking,2,5,7
UTTARAKHAND,2003,Student,9,8,17
UTTARAKHAND,2003,Unemployed,55,0,55
UTTARAKHAND,2003,Self-employed (Business activity),11,0,11
UTTARAKHAND,2003,Professional Activity,9,1,10
UTTARAKHAND,2003,Farming/Agriculture Activity,39,2,41
UTTARAKHAND,2003,Others (Please Specify),47,9,56
UTTARAKHAND,2003,Retired Person,1,0,1
UTTARAKHAND,2003,Others (Please Specify),15,7,22
UTTARAKHAND,2003,Total,262,129,391
UTTARAKHAND,2003,Total Salaried,76,21,97
UTTARAKHAND,2003,Total Self-employed,106,12,118
UTTARAKHAND,2004,House Wife,0,63,63
UTTARAKHAND,2004,Service (Government),7,0,7
UTTARAKHAND,2004,Service (Private),18,3,21
UTTARAKHAND,2004,Public Sector Undertaking,0,0,0
UTTARAKHAND,2004,Student,7,9,16
UTTARAKHAND,2004,Unemployed,26,1,27
UTTARAKHAND,2004,Self-employed (Business activity),8,0,8
UTTARAKHAND,2004,Professional Activity,0,1,1
UTTARAKHAND,2004,Farming/Agriculture Activity,18,4,22
UTTARAKHAND,2004,Others (Please Specify),21,3,24
UTTARAKHAND,2004,Retired Person,1,0,1
UTTARAKHAND,2004,Others (Please Specify),42,5,47
UTTARAKHAND,2004,Total,148,89,237
UTTARAKHAND,2004,Total Salaried,25,3,28
UTTARAKHAND,2004,Total Self-employed,47,8,55
UTTARAKHAND,2005,House Wife,0,67,67
UTTARAKHAND,2005,Service (Government),7,0,7
UTTARAKHAND,2005,Service (Private),17,3,20
UTTARAKHAND,2005,Public Sector Undertaking,6,1,7
UTTARAKHAND,2005,Student,8,6,14
UTTARAKHAND,2005,Unemployed,43,1,44
UTTARAKHAND,2005,Self-employed (Business activity),26,0,26
UTTARAKHAND,2005,Professional Activity,10,0,10
UTTARAKHAND,2005,Farming/Agriculture Activity,15,9,24
UTTARAKHAND,2005,Others (Please Specify),20,2,22
UTTARAKHAND,2005,Retired Person,3,0,3
UTTARAKHAND,2005,Others (Please Specify),25,4,29
UTTARAKHAND,2005,Total,180,93,273
UTTARAKHAND,2005,Total Salaried,30,4,34
UTTARAKHAND,2005,Total Self-employed,71,11,82
UTTARAKHAND,2006,House Wife,0,86,86
UTTARAKHAND,2006,Service (Government),13,1,14
UTTARAKHAND,2006,Service (Private),18,9,27
UTTARAKHAND,2006,Public Sector Undertaking,6,6,12
UTTARAKHAND,2006,Student,4,10,14
UTTARAKHAND,2006,Unemployed,19,5,24
UTTARAKHAND,2006,Self-employed (Business activity),21,2,23
UTTARAKHAND,2006,Professional Activity,6,3,9
UTTARAKHAND,2006,Farming/Agriculture Activity,33,18,51
UTTARAKHAND,2006,Others (Please Specify),15,2,17
UTTARAKHAND,2006,Retired Person,4,0,4
UTTARAKHAND,2006,Others (Please Specify),34,11,45
UTTARAKHAND,2006,Total,173,153,326
UTTARAKHAND,2006,Total Salaried,37,16,53
UTTARAKHAND,2006,Total Self-employed,75,25,100
UTTARAKHAND,2007,House Wife,0,67,67
UTTARAKHAND,2007,Service (Government),5,2,7
UTTARAKHAND,2007,Service (Private),26,5,31
UTTARAKHAND,2007,Public Sector Undertaking,13,6,19
UTTARAKHAND,2007,Student,8,7,15
UTTARAKHAND,2007,Unemployed,20,6,26
UTTARAKHAND,2007,Self-employed (Business activity),10,2,12
UTTARAKHAND,2007,Professional Activity,4,1,5
UTTARAKHAND,2007,Farming/Agriculture Activity,18,10,28
UTTARAKHAND,2007,Others (Please Specify),8,5,13
UTTARAKHAND,2007,Retired Person,0,0,0
UTTARAKHAND,2007,Others (Please Specify),18,7,25
UTTARAKHAND,2007,Total,130,118,248
UTTARAKHAND,2007,Total Salaried,44,13,57
UTTARAKHAND,2007,Total Self-employed,40,18,58
UTTARAKHAND,2008,House Wife,0,44,44
UTTARAKHAND,2008,Service (Government),7,0,7
UTTARAKHAND,2008,Service (Private),17,6,23
UTTARAKHAND,2008,Public Sector Undertaking,5,1,6
UTTARAKHAND,2008,Student,6,7,13
UTTARAKHAND,2008,Unemployed,5,2,7
UTTARAKHAND,2008,Self-employed (Business activity),6,0,6
UTTARAKHAND,2008,Professional Activity,0,0,0
UTTARAKHAND,2008,Farming/Agriculture Activity,21,7,28
UTTARAKHAND,2008,Others (Please Specify),13,15,28
UTTARAKHAND,2008,Retired Person,3,0,3
UTTARAKHAND,2008,Others (Please Specify),21,5,26
UTTARAKHAND,2008,Total,104,87,191
UTTARAKHAND,2008,Total Salaried,29,7,36
UTTARAKHAND,2008,Total Self-employed,40,22,62
UTTARAKHAND,2009,House Wife,0,75,75
UTTARAKHAND,2009,Service (Government),8,0,8
UTTARAKHAND,2009,Service (Private),33,6,39
UTTARAKHAND,2009,Public Sector Undertaking,6,2,8
UTTARAKHAND,2009,Student,21,19,40
UTTARAKHAND,2009,Unemployed,31,5,36
UTTARAKHAND,2009,Self-employed (Business activity),8,2,10
UTTARAKHAND,2009,Professional Activity,27,7,34
UTTARAKHAND,2009,Farming/Agriculture Activity,26,4,30
UTTARAKHAND,2009,Others (Please Specify),0,0,0
UTTARAKHAND,2009,Retired Person,42,20,62
UTTARAKHAND,2009,Others (Please Specify),0,0,0
UTTARAKHAND,2009,Total,202,140,342
UTTARAKHAND,2009,Total Salaried,47,8,55
UTTARAKHAND,2009,Total Self-employed,61,13,74
UTTARAKHAND,2010,House Wife,0,54,54
UTTARAKHAND,2010,Service (Government),11,3,14
UTTARAKHAND,2010,Service (Private),21,3,24
UTTARAKHAND,2010,Public Sector Undertaking,0,1,1
UTTARAKHAND,2010,Student,10,24,34
UTTARAKHAND,2010,Unemployed,19,3,22
UTTARAKHAND,2010,Self-employed (Business activity),15,0,15
UTTARAKHAND,2010,Professional Activity,1,0,1
UTTARAKHAND,2010,Farming/Agriculture Activity,33,6,39
UTTARAKHAND,2010,Others (Please Specify),26,8,34
UTTARAKHAND,2010,Retired Person,3,0,3
UTTARAKHAND,2010,Others (Please Specify),25,15,40
UTTARAKHAND,2010,Total,164,117,281
UTTARAKHAND,2010,Total Salaried,32,7,39
UTTARAKHAND,2010,Total Self-employed,75,14,89
UTTARAKHAND,2011,House Wife,0,51,51
UTTARAKHAND,2011,Service (Government),17,2,19
UTTARAKHAND,2011,Service (Private),31,6,37
UTTARAKHAND,2011,Public Sector Undertaking,5,4,9
UTTARAKHAND,2011,Student,13,17,30
UTTARAKHAND,2011,Unemployed,36,5,41
UTTARAKHAND,2011,Self-employed (Business activity),15,0,15
UTTARAKHAND,2011,Professional Activity,3,0,3
UTTARAKHAND,2011,Farming/Agriculture Activity,22,3,25
UTTARAKHAND,2011,Others (Please Specify),26,18,44
UTTARAKHAND,2011,Retired Person,4,0,4
UTTARAKHAND,2011,Others (Please Specify),20,19,39
UTTARAKHAND,2011,Total,192,125,317
UTTARAKHAND,2011,Total Salaried,53,12,65
UTTARAKHAND,2011,Total Self-employed,66,21,87
UTTARAKHAND,2012,House Wife,0,63,63
UTTARAKHAND,2012,Service (Government),7,0,7
UTTARAKHAND,2012,Service (Private),45,2,47
UTTARAKHAND,2012,Public Sector Undertaking,7,1,8
UTTARAKHAND,2012,Student,11,9,20
UTTARAKHAND,2012,Unemployed,21,5,26
UTTARAKHAND,2012,Self-employed (Business activity),20,0,20
UTTARAKHAND,2012,Professional Activity,1,0,1
UTTARAKHAND,2012,Farming/Agriculture Activity,12,2,14
UTTARAKHAND,2012,Others (Please Specify),32,16,48
UTTARAKHAND,2012,Retired Person,0,0,0
UTTARAKHAND,2012,Others (Please Specify),93,77,170
UTTARAKHAND,2012,Total,249,175,424
UTTARAKHAND,2012,Total Salaried,59,3,62
UTTARAKHAND,2012,Total Self-employed,65,18,83
WEST BENGAL,2001,House Wife,0,1555,1555
WEST BENGAL,2001,Service (Government),182,121,303
WEST BENGAL,2001,Service (Private),995,425,1420
WEST BENGAL,2001,Public Sector Undertaking,473,269,742
WEST BENGAL,2001,Student,397,417,814
WEST BENGAL,2001,Unemployed,646,223,869
WEST BENGAL,2001,Self-employed (Business activity),509,166,675
WEST BENGAL,2001,Professional Activity,195,81,276
WEST BENGAL,2001,Farming/Agriculture Activity,935,311,1246
WEST BENGAL,2001,Others (Please Specify),1157,847,2004
WEST BENGAL,2001,Retired Person,102,45,147
WEST BENGAL,2001,Others (Please Specify),1904,1735,3639
WEST BENGAL,2001,Total,7495,6195,13690
WEST BENGAL,2001,Total Salaried,1650,815,2465
WEST BENGAL,2001,Total Self-employed,2796,1405,4201
WEST BENGAL,2002,House Wife,0,2294,2294
WEST BENGAL,2002,Service (Government),148,106,254
WEST BENGAL,2002,Service (Private),792,374,1166
WEST BENGAL,2002,Public Sector Undertaking,406,213,619
WEST BENGAL,2002,Student,399,268,667
WEST BENGAL,2002,Unemployed,660,290,950
WEST BENGAL,2002,Self-employed (Business activity),619,170,789
WEST BENGAL,2002,Professional Activity,164,45,209
WEST BENGAL,2002,Farming/Agriculture Activity,1143,375,1518
WEST BENGAL,2002,Others (Please Specify),1109,647,1756
WEST BENGAL,2002,Retired Person,135,18,153
WEST BENGAL,2002,Others (Please Specify),1549,1083,2632
WEST BENGAL,2002,Total,7124,5883,13007
WEST BENGAL,2002,Total Salaried,1346,693,2039
WEST BENGAL,2002,Total Self-employed,3035,1237,4272
WEST BENGAL,2003,House Wife,0,4083,4083
WEST BENGAL,2003,Service (Government),202,28,230
WEST BENGAL,2003,Service (Private),737,95,832
WEST BENGAL,2003,Public Sector Undertaking,946,141,1087
WEST BENGAL,2003,Student,538,573,1111
WEST BENGAL,2003,Unemployed,757,151,908
WEST BENGAL,2003,Self-employed (Business activity),942,68,1010
WEST BENGAL,2003,Professional Activity,368,21,389
WEST BENGAL,2003,Farming/Agriculture Activity,920,116,1036
WEST BENGAL,2003,Others (Please Specify),868,363,1231
WEST BENGAL,2003,Retired Person,241,7,248
WEST BENGAL,2003,Others (Please Specify),905,210,1115
WEST BENGAL,2003,Total,7424,5856,13280
WEST BENGAL,2003,Total Salaried,1885,264,2149
WEST BENGAL,2003,Total Self-employed,3098,568,3666
WEST BENGAL,2004,House Wife,0,3352,3352
WEST BENGAL,2004,Service (Government),125,26,151
WEST BENGAL,2004,Service (Private),597,77,674
WEST BENGAL,2004,Public Sector Undertaking,651,66,717
WEST BENGAL,2004,Student,448,361,809
WEST BENGAL,2004,Unemployed,713,158,871
WEST BENGAL,2004,Self-employed (Business activity),746,26,772
WEST BENGAL,2004,Professional Activity,286,9,295
WEST BENGAL,2004,Farming/Agriculture Activity,797,25,822
WEST BENGAL,2004,Others (Please Specify),1115,519,1634
WEST BENGAL,2004,Retired Person,218,13,231
WEST BENGAL,2004,Others (Please Specify),1965,1131,3096
WEST BENGAL,2004,Total,7661,5763,13424
WEST BENGAL,2004,Total Salaried,1373,169,1542
WEST BENGAL,2004,Total Self-employed,2944,579,3523
WEST BENGAL,2005,House Wife,0,4155,4155
WEST BENGAL,2005,Service (Government),164,20,184
WEST BENGAL,2005,Service (Private),1119,245,1364
WEST BENGAL,2005,Public Sector Undertaking,471,46,517
WEST BENGAL,2005,Student,453,278,731
WEST BENGAL,2005,Unemployed,928,221,1149
WEST BENGAL,2005,Self-employed (Business activity),904,96,1000
WEST BENGAL,2005,Professional Activity,346,6,352
WEST BENGAL,2005,Farming/Agriculture Activity,853,112,965
WEST BENGAL,2005,Others (Please Specify),1712,458,2170
WEST BENGAL,2005,Retired Person,212,15,227
WEST BENGAL,2005,Others (Please Specify),1452,749,2201
WEST BENGAL,2005,Total,8614,6401,15015
WEST BENGAL,2005,Total Salaried,1754,311,2065
WEST BENGAL,2005,Total Self-employed,3815,672,4487
WEST BENGAL,2006,House Wife,0,5020,5020
WEST BENGAL,2006,Service (Government),163,36,199
WEST BENGAL,2006,Service (Private),688,130,818
WEST BENGAL,2006,Public Sector Undertaking,776,79,855
WEST BENGAL,2006,Student,639,502,1141
WEST BENGAL,2006,Unemployed,1567,181,1748
WEST BENGAL,2006,Self-employed (Business activity),1400,51,1451
WEST BENGAL,2006,Professional Activity,738,38,776
WEST BENGAL,2006,Farming/Agriculture Activity,963,226,1189
WEST BENGAL,2006,Others (Please Specify),1823,288,2111
WEST BENGAL,2006,Retired Person,297,46,343
WEST BENGAL,2006,Others (Please Specify),66,8,74
WEST BENGAL,2006,Total,9120,6605,15725
WEST BENGAL,2006,Total Salaried,1627,245,1872
WEST BENGAL,2006,Total Self-employed,4924,603,5527
WEST BENGAL,2007,House Wife,0,3362,3362
WEST BENGAL,2007,Service (Government),116,24,140
WEST BENGAL,2007,Service (Private),579,103,682
WEST BENGAL,2007,Public Sector Undertaking,655,84,739
WEST BENGAL,2007,Student,649,489,1138
WEST BENGAL,2007,Unemployed,805,362,1167
WEST BENGAL,2007,Self-employed (Business activity),1158,39,1197
WEST BENGAL,2007,Professional Activity,263,3,266
WEST BENGAL,2007,Farming/Agriculture Activity,878,224,1102
WEST BENGAL,2007,Others (Please Specify),2079,884,2963
WEST BENGAL,2007,Retired Person,95,16,111
WEST BENGAL,2007,Others (Please Specify),1228,765,1993
WEST BENGAL,2007,Total,8505,6355,14860
WEST BENGAL,2007,Total Salaried,1350,211,1561
WEST BENGAL,2007,Total Self-employed,4378,1150,5528
WEST BENGAL,2008,House Wife,0,3244,3244
WEST BENGAL,2008,Service (Government),120,25,145
WEST BENGAL,2008,Service (Private),535,83,618
WEST BENGAL,2008,Public Sector Undertaking,537,85,622
WEST BENGAL,2008,Student,555,385,940
WEST BENGAL,2008,Unemployed,1111,446,1557
WEST BENGAL,2008,Self-employed (Business activity),882,52,934
WEST BENGAL,2008,Professional Activity,234,13,247
WEST BENGAL,2008,Farming/Agriculture Activity,660,99,759
WEST BENGAL,2008,Others (Please Specify),1539,652,2191
WEST BENGAL,2008,Retired Person,63,10,73
WEST BENGAL,2008,Others (Please Specify),2133,1389,3522
WEST BENGAL,2008,Total,8369,6483,14852
WEST BENGAL,2008,Total Salaried,1192,193,1385
WEST BENGAL,2008,Total Self-employed,3315,816,4131
WEST BENGAL,2009,House Wife,0,3305,3305
WEST BENGAL,2009,Service (Government),179,60,239
WEST BENGAL,2009,Service (Private),656,160,816
WEST BENGAL,2009,Public Sector Undertaking,514,93,607
WEST BENGAL,2009,Student,453,417,870
WEST BENGAL,2009,Unemployed,1151,204,1355
WEST BENGAL,2009,Self-employed (Business activity),1138,200,1338
WEST BENGAL,2009,Professional Activity,180,28,208
WEST BENGAL,2009,Farming/Agriculture Activity,929,125,1054
WEST BENGAL,2009,Others (Please Specify),1504,506,2010
WEST BENGAL,2009,Retired Person,58,30,88
WEST BENGAL,2009,Others (Please Specify),1732,1026,2758
WEST BENGAL,2009,Total,8494,6154,14648
WEST BENGAL,2009,Total Salaried,1349,313,1662
WEST BENGAL,2009,Total Self-employed,3751,859,4610
WEST BENGAL,2010,House Wife,0,2928,2928
WEST BENGAL,2010,Service (Government),141,19,160
WEST BENGAL,2010,Service (Private),646,157,803
WEST BENGAL,2010,Public Sector Undertaking,544,124,668
WEST BENGAL,2010,Student,544,405,949
WEST BENGAL,2010,Unemployed,764,265,1029
WEST BENGAL,2010,Self-employed (Business activity),851,37,888
WEST BENGAL,2010,Professional Activity,401,100,501
WEST BENGAL,2010,Farming/Agriculture Activity,800,193,993
WEST BENGAL,2010,Others (Please Specify),2477,1342,3819
WEST BENGAL,2010,Retired Person,55,11,66
WEST BENGAL,2010,Others (Please Specify),2078,1155,3233
WEST BENGAL,2010,Total,9301,6736,16037
WEST BENGAL,2010,Total Salaried,1331,300,1631
WEST BENGAL,2010,Total Self-employed,4529,1672,6201
WEST BENGAL,2011,House Wife,0,2955,2955
WEST BENGAL,2011,Service (Government),106,17,123
WEST BENGAL,2011,Service (Private),572,176,748
WEST BENGAL,2011,Public Sector Undertaking,509,183,692
WEST BENGAL,2011,Student,527,507,1034
WEST BENGAL,2011,Unemployed,1195,383,1578
WEST BENGAL,2011,Self-employed (Business activity),1069,87,1156
WEST BENGAL,2011,Professional Activity,367,47,414
WEST BENGAL,2011,Farming/Agriculture Activity,662,145,807
WEST BENGAL,2011,Others (Please Specify),1783,953,2736
WEST BENGAL,2011,Retired Person,61,11,72
WEST BENGAL,2011,Others (Please Specify),2773,1404,4177
WEST BENGAL,2011,Total,9624,6868,16492
WEST BENGAL,2011,Total Salaried,1187,376,1563
WEST BENGAL,2011,Total Self-employed,3881,1232,5113
WEST BENGAL,2012,House Wife,0,0,0
WEST BENGAL,2012,Service (Government),0,0,0
WEST BENGAL,2012,Service (Private),0,0,0
WEST BENGAL,2012,Public Sector Undertaking,0,0,0
WEST BENGAL,2012,Student,0,0,0
WEST BENGAL,2012,Unemployed,0,0,0
WEST BENGAL,2012,Self-employed (Business activity),0,0,0
WEST BENGAL,2012,Professional Activity,0,0,0
WEST BENGAL,2012,Farming/Agriculture Activity,0,0,0
WEST BENGAL,2012,Others (Please Specify),0,0,0
WEST BENGAL,2012,Retired Person,0,0,0
WEST BENGAL,2012,Others (Please Specify),0,0,0
WEST BENGAL,2012,Total,0,0,0
WEST BENGAL,2012,Total Salaried,0,0,0
WEST BENGAL,2012,Total Self-employed,0,0,0
A & N ISLANDS,2001,House Wife,0,38,38
A & N ISLANDS,2001,Service (Government),20,0,20
A & N ISLANDS,2001,Service (Private),32,0,32
A & N ISLANDS,2001,Public Sector Undertaking,4,0,4
A & N ISLANDS,2001,Student,3,11,14
A & N ISLANDS,2001,Unemployed,0,0,0
A & N ISLANDS,2001,Self-employed (Business activity),0,0,0
A & N ISLANDS,2001,Professional Activity,0,0,0
A & N ISLANDS,2001,Farming/Agriculture Activity,3,0,3
A & N ISLANDS,2001,Others (Please Specify),15,1,16
A & N ISLANDS,2001,Retired Person,2,0,2
A & N ISLANDS,2001,Others (Please Specify),0,0,0
A & N ISLANDS,2001,Total,79,50,129
A & N ISLANDS,2001,Total Salaried,56,0,56
A & N ISLANDS,2001,Total Self-employed,18,1,19
A & N ISLANDS,2002,House Wife,0,44,44
A & N ISLANDS,2002,Service (Government),18,1,19
A & N ISLANDS,2002,Service (Private),56,0,56
A & N ISLANDS,2002,Public Sector Undertaking,0,0,0
A & N ISLANDS,2002,Student,5,8,13
A & N ISLANDS,2002,Unemployed,0,0,0
A & N ISLANDS,2002,Self-employed (Business activity),1,0,1
A & N ISLANDS,2002,Professional Activity,0,0,0
A & N ISLANDS,2002,Farming/Agriculture Activity,7,0,7
A & N ISLANDS,2002,Others (Please Specify),1,0,1
A & N ISLANDS,2002,Retired Person,3,0,3
A & N ISLANDS,2002,Others (Please Specify),0,0,0
A & N ISLANDS,2002,Total,91,53,144
A & N ISLANDS,2002,Total Salaried,74,1,75
A & N ISLANDS,2002,Total Self-employed,9,0,9
A & N ISLANDS,2003,House Wife,0,28,28
A & N ISLANDS,2003,Service (Government),14,1,15
A & N ISLANDS,2003,Service (Private),42,0,42
A & N ISLANDS,2003,Public Sector Undertaking,3,0,3
A & N ISLANDS,2003,Student,2,8,10
A & N ISLANDS,2003,Unemployed,6,6,12
A & N ISLANDS,2003,Self-employed (Business activity),0,0,0
A & N ISLANDS,2003,Professional Activity,0,0,0
A & N ISLANDS,2003,Farming/Agriculture Activity,1,0,1
A & N ISLANDS,2003,Others (Please Specify),0,0,0
A & N ISLANDS,2003,Retired Person,2,0,2
A & N ISLANDS,2003,Others (Please Specify),0,0,0
A & N ISLANDS,2003,Total,70,43,113
A & N ISLANDS,2003,Total Salaried,59,1,60
A & N ISLANDS,2003,Total Self-employed,1,0,1
A & N ISLANDS,2004,House Wife,0,25,25
A & N ISLANDS,2004,Service (Government),18,2,20
A & N ISLANDS,2004,Service (Private),36,1,37
A & N ISLANDS,2004,Public Sector Undertaking,0,0,0
A & N ISLANDS,2004,Student,8,8,16
A & N ISLANDS,2004,Unemployed,0,1,1
A & N ISLANDS,2004,Self-employed (Business activity),4,0,4
A & N ISLANDS,2004,Professional Activity,2,0,2
A & N ISLANDS,2004,Farming/Agriculture Activity,3,0,3
A & N ISLANDS,2004,Others (Please Specify),0,1,1
A & N ISLANDS,2004,Retired Person,2,0,2
A & N ISLANDS,2004,Others (Please Specify),8,3,11
A & N ISLANDS,2004,Total,81,41,122
A & N ISLANDS,2004,Total Salaried,54,3,57
A & N ISLANDS,2004,Total Self-employed,9,1,10
A & N ISLANDS,2005,House Wife,0,32,32
A & N ISLANDS,2005,Service (Government),13,0,13
A & N ISLANDS,2005,Service (Private),47,4,51
A & N ISLANDS,2005,Public Sector Undertaking,0,0,0
A & N ISLANDS,2005,Student,5,7,12
A & N ISLANDS,2005,Unemployed,3,9,12
A & N ISLANDS,2005,Self-employed (Business activity),5,0,5
A & N ISLANDS,2005,Professional Activity,0,0,0
A & N ISLANDS,2005,Farming/Agriculture Activity,7,1,8
A & N ISLANDS,2005,Others (Please Specify),6,0,6
A & N ISLANDS,2005,Retired Person,0,0,0
A & N ISLANDS,2005,Others (Please Specify),0,0,0
A & N ISLANDS,2005,Total,86,53,139
A & N ISLANDS,2005,Total Salaried,60,4,64
A & N ISLANDS,2005,Total Self-employed,18,1,19
A & N ISLANDS,2006,House Wife,0,33,33
A & N ISLANDS,2006,Service (Government),11,0,11
A & N ISLANDS,2006,Service (Private),62,1,63
A & N ISLANDS,2006,Public Sector Undertaking,0,0,0
A & N ISLANDS,2006,Student,1,3,4
A & N ISLANDS,2006,Unemployed,2,0,2
A & N ISLANDS,2006,Self-employed (Business activity),4,0,4
A & N ISLANDS,2006,Professional Activity,0,0,0
A & N ISLANDS,2006,Farming/Agriculture Activity,6,0,6
A & N ISLANDS,2006,Others (Please Specify),0,0,0
A & N ISLANDS,2006,Retired Person,0,0,0
A & N ISLANDS,2006,Others (Please Specify),10,0,10
A & N ISLANDS,2006,Total,96,37,133
A & N ISLANDS,2006,Total Salaried,73,1,74
A & N ISLANDS,2006,Total Self-employed,10,0,10
A & N ISLANDS,2007,House Wife,0,30,30
A & N ISLANDS,2007,Service (Government),9,1,10
A & N ISLANDS,2007,Service (Private),39,1,40
A & N ISLANDS,2007,Public Sector Undertaking,0,0,0
A & N ISLANDS,2007,Student,4,13,17
A & N ISLANDS,2007,Unemployed,12,0,12
A & N ISLANDS,2007,Self-employed (Business activity),0,0,0
A & N ISLANDS,2007,Professional Activity,0,0,0
A & N ISLANDS,2007,Farming/Agriculture Activity,16,0,16
A & N ISLANDS,2007,Others (Please Specify),7,0,7
A & N ISLANDS,2007,Retired Person,3,0,3
A & N ISLANDS,2007,Others (Please Specify),10,11,21
A & N ISLANDS,2007,Total,100,56,156
A & N ISLANDS,2007,Total Salaried,48,2,50
A & N ISLANDS,2007,Total Self-employed,23,0,23
A & N ISLANDS,2008,House Wife,0,32,32
A & N ISLANDS,2008,Service (Government),7,0,7
A & N ISLANDS,2008,Service (Private),43,1,44
A & N ISLANDS,2008,Public Sector Undertaking,0,0,0
A & N ISLANDS,2008,Student,4,7,11
A & N ISLANDS,2008,Unemployed,5,0,5
A & N ISLANDS,2008,Self-employed (Business activity),1,0,1
A & N ISLANDS,2008,Professional Activity,0,0,0
A & N ISLANDS,2008,Farming/Agriculture Activity,23,0,23
A & N ISLANDS,2008,Others (Please Specify),4,0,4
A & N ISLANDS,2008,Retired Person,4,0,4
A & N ISLANDS,2008,Others (Please Specify),7,5,12
A & N ISLANDS,2008,Total,98,45,143
A & N ISLANDS,2008,Total Salaried,50,1,51
A & N ISLANDS,2008,Total Self-employed,28,0,28
A & N ISLANDS,2009,House Wife,0,29,29
A & N ISLANDS,2009,Service (Government),13,1,14
A & N ISLANDS,2009,Service (Private),42,2,44
A & N ISLANDS,2009,Public Sector Undertaking,0,0,0
A & N ISLANDS,2009,Student,3,10,13
A & N ISLANDS,2009,Unemployed,0,0,0
A & N ISLANDS,2009,Self-employed (Business activity),2,0,2
A & N ISLANDS,2009,Professional Activity,0,0,0
A & N ISLANDS,2009,Farming/Agriculture Activity,19,0,19
A & N ISLANDS,2009,Others (Please Specify),6,3,9
A & N ISLANDS,2009,Retired Person,1,0,1
A & N ISLANDS,2009,Others (Please Specify),0,0,0
A & N ISLANDS,2009,Total,86,45,131
A & N ISLANDS,2009,Total Salaried,55,3,58
A & N ISLANDS,2009,Total Self-employed,27,3,30
A & N ISLANDS,2010,House Wife,0,31,31
A & N ISLANDS,2010,Service (Government),18,1,19
A & N ISLANDS,2010,Service (Private),48,2,50
A & N ISLANDS,2010,Public Sector Undertaking,0,0,0
A & N ISLANDS,2010,Student,8,6,14
A & N ISLANDS,2010,Unemployed,13,4,17
A & N ISLANDS,2010,Self-employed (Business activity),6,0,6
A & N ISLANDS,2010,Professional Activity,0,0,0
A & N ISLANDS,2010,Farming/Agriculture Activity,8,0,8
A & N ISLANDS,2010,Others (Please Specify),2,0,2
A & N ISLANDS,2010,Retired Person,8,0,8
A & N ISLANDS,2010,Others (Please Specify),1,0,1
A & N ISLANDS,2010,Total,112,44,156
A & N ISLANDS,2010,Total Salaried,66,3,69
A & N ISLANDS,2010,Total Self-employed,16,0,16
A & N ISLANDS,2011,House Wife,0,10,10
A & N ISLANDS,2011,Service (Government),18,4,22
A & N ISLANDS,2011,Service (Private),33,10,43
A & N ISLANDS,2011,Public Sector Undertaking,0,0,0
A & N ISLANDS,2011,Student,10,13,23
A & N ISLANDS,2011,Unemployed,10,1,11
A & N ISLANDS,2011,Self-employed (Business activity),7,2,9
A & N ISLANDS,2011,Professional Activity,0,0,0
A & N ISLANDS,2011,Farming/Agriculture Activity,0,0,0
A & N ISLANDS,2011,Others (Please Specify),3,1,4
A & N ISLANDS,2011,Retired Person,5,1,6
A & N ISLANDS,2011,Others (Please Specify),8,0,8
A & N ISLANDS,2011,Total,94,42,136
A & N ISLANDS,2011,Total Salaried,51,14,65
A & N ISLANDS,2011,Total Self-employed,10,3,13
A & N ISLANDS,2012,House Wife,0,28,28
A & N ISLANDS,2012,Service (Government),18,3,21
A & N ISLANDS,2012,Service (Private),49,1,50
A & N ISLANDS,2012,Public Sector Undertaking,0,0,0
A & N ISLANDS,2012,Student,4,5,9
A & N ISLANDS,2012,Unemployed,4,1,5
A & N ISLANDS,2012,Self-employed (Business activity),0,0,0
A & N ISLANDS,2012,Professional Activity,0,0,0
A & N ISLANDS,2012,Farming/Agriculture Activity,0,0,0
A & N ISLANDS,2012,Others (Please Specify),4,3,7
A & N ISLANDS,2012,Retired Person,1,0,1
A & N ISLANDS,2012,Others (Please Specify),0,0,0
A & N ISLANDS,2012,Total,80,41,121
A & N ISLANDS,2012,Total Salaried,67,4,71
A & N ISLANDS,2012,Total Self-employed,4,3,7
CHANDIGARH,2001,House Wife,0,19,19
CHANDIGARH,2001,Service (Government),3,0,3
CHANDIGARH,2001,Service (Private),8,0,8
CHANDIGARH,2001,Public Sector Undertaking,0,0,0
CHANDIGARH,2001,Student,4,2,6
CHANDIGARH,2001,Unemployed,1,0,1
CHANDIGARH,2001,Self-employed (Business activity),1,0,1
CHANDIGARH,2001,Professional Activity,0,0,0
CHANDIGARH,2001,Farming/Agriculture Activity,0,0,0
CHANDIGARH,2001,Others (Please Specify),6,0,6
CHANDIGARH,2001,Retired Person,1,0,1
CHANDIGARH,2001,Others (Please Specify),15,10,25
CHANDIGARH,2001,Total,39,31,70
CHANDIGARH,2001,Total Salaried,11,0,11
CHANDIGARH,2001,Total Self-employed,7,0,7
CHANDIGARH,2002,House Wife,0,21,21
CHANDIGARH,2002,Service (Government),3,0,3
CHANDIGARH,2002,Service (Private),12,1,13
CHANDIGARH,2002,Public Sector Undertaking,0,0,0
CHANDIGARH,2002,Student,5,4,9
CHANDIGARH,2002,Unemployed,3,4,7
CHANDIGARH,2002,Self-employed (Business activity),1,0,1
CHANDIGARH,2002,Professional Activity,0,0,0
CHANDIGARH,2002,Farming/Agriculture Activity,0,0,0
CHANDIGARH,2002,Others (Please Specify),0,0,0
CHANDIGARH,2002,Retired Person,0,0,0
CHANDIGARH,2002,Others (Please Specify),29,4,33
CHANDIGARH,2002,Total,53,34,87
CHANDIGARH,2002,Total Salaried,15,1,16
CHANDIGARH,2002,Total Self-employed,1,0,1
CHANDIGARH,2003,House Wife,0,22,22
CHANDIGARH,2003,Service (Government),9,0,9
CHANDIGARH,2003,Service (Private),24,1,25
CHANDIGARH,2003,Public Sector Undertaking,0,0,0
CHANDIGARH,2003,Student,4,8,12
CHANDIGARH,2003,Unemployed,12,3,15
CHANDIGARH,2003,Self-employed (Business activity),0,0,0
CHANDIGARH,2003,Professional Activity,2,0,2
CHANDIGARH,2003,Farming/Agriculture Activity,2,0,2
CHANDIGARH,2003,Others (Please Specify),0,0,0
CHANDIGARH,2003,Retired Person,2,0,2
CHANDIGARH,2003,Others (Please Specify),13,1,14
CHANDIGARH,2003,Total,68,35,103
CHANDIGARH,2003,Total Salaried,33,1,34
CHANDIGARH,2003,Total Self-employed,4,0,4
CHANDIGARH,2004,House Wife,0,12,12
CHANDIGARH,2004,Service (Government),3,1,4
CHANDIGARH,2004,Service (Private),11,0,11
CHANDIGARH,2004,Public Sector Undertaking,0,0,0
CHANDIGARH,2004,Student,5,8,13
CHANDIGARH,2004,Unemployed,12,1,13
CHANDIGARH,2004,Self-employed (Business activity),4,0,4
CHANDIGARH,2004,Professional Activity,1,0,1
CHANDIGARH,2004,Farming/Agriculture Activity,0,0,0
CHANDIGARH,2004,Others (Please Specify),12,0,12
CHANDIGARH,2004,Retired Person,0,0,0
CHANDIGARH,2004,Others (Please Specify),4,1,5
CHANDIGARH,2004,Total,52,23,75
CHANDIGARH,2004,Total Salaried,14,1,15
CHANDIGARH,2004,Total Self-employed,17,0,17
CHANDIGARH,2005,House Wife,0,14,14
CHANDIGARH,2005,Service (Government),2,1,3
CHANDIGARH,2005,Service (Private),17,1,18
CHANDIGARH,2005,Public Sector Undertaking,5,0,5
CHANDIGARH,2005,Student,3,3,6
CHANDIGARH,2005,Unemployed,15,2,17
CHANDIGARH,2005,Self-employed (Business activity),11,0,11
CHANDIGARH,2005,Professional Activity,0,0,0
CHANDIGARH,2005,Farming/Agriculture Activity,0,0,0
CHANDIGARH,2005,Others (Please Specify),9,4,13
CHANDIGARH,2005,Retired Person,0,0,0
CHANDIGARH,2005,Others (Please Specify),1,1,2
CHANDIGARH,2005,Total,63,26,89
CHANDIGARH,2005,Total Salaried,24,2,26
CHANDIGARH,2005,Total Self-employed,20,4,24
CHANDIGARH,2006,House Wife,0,11,11
CHANDIGARH,2006,Service (Government),7,0,7
CHANDIGARH,2006,Service (Private),13,2,15
CHANDIGARH,2006,Public Sector Undertaking,0,0,0
CHANDIGARH,2006,Student,11,9,20
CHANDIGARH,2006,Unemployed,23,2,25
CHANDIGARH,2006,Self-employed (Business activity),1,0,1
CHANDIGARH,2006,Professional Activity,0,0,0
CHANDIGARH,2006,Farming/Agriculture Activity,1,0,1
CHANDIGARH,2006,Others (Please Specify),0,0,0
CHANDIGARH,2006,Retired Person,0,0,0
CHANDIGARH,2006,Others (Please Specify),0,0,0
CHANDIGARH,2006,Total,56,24,80
CHANDIGARH,2006,Total Salaried,20,2,22
CHANDIGARH,2006,Total Self-employed,2,0,2
CHANDIGARH,2007,House Wife,0,21,21
CHANDIGARH,2007,Service (Government),4,1,5
CHANDIGARH,2007,Service (Private),17,0,17
CHANDIGARH,2007,Public Sector Undertaking,0,0,0
CHANDIGARH,2007,Student,15,0,15
CHANDIGARH,2007,Unemployed,10,0,10
CHANDIGARH,2007,Self-employed (Business activity),3,0,3
CHANDIGARH,2007,Professional Activity,0,0,0
CHANDIGARH,2007,Farming/Agriculture Activity,0,0,0
CHANDIGARH,2007,Others (Please Specify),5,0,5
CHANDIGARH,2007,Retired Person,2,0,2
CHANDIGARH,2007,Others (Please Specify),4,0,4
CHANDIGARH,2007,Total,60,22,82
CHANDIGARH,2007,Total Salaried,21,1,22
CHANDIGARH,2007,Total Self-employed,8,0,8
CHANDIGARH,2008,House Wife,0,17,17
CHANDIGARH,2008,Service (Government),3,0,3
CHANDIGARH,2008,Service (Private),15,3,18
CHANDIGARH,2008,Public Sector Undertaking,0,0,0
CHANDIGARH,2008,Student,6,5,11
CHANDIGARH,2008,Unemployed,23,0,23
CHANDIGARH,2008,Self-employed (Business activity),8,0,8
CHANDIGARH,2008,Professional Activity,1,0,1
CHANDIGARH,2008,Farming/Agriculture Activity,0,0,0
CHANDIGARH,2008,Others (Please Specify),0,0,0
CHANDIGARH,2008,Retired Person,2,0,2
CHANDIGARH,2008,Others (Please Specify),0,0,0
CHANDIGARH,2008,Total,58,25,83
CHANDIGARH,2008,Total Salaried,18,3,21
CHANDIGARH,2008,Total Self-employed,9,0,9
CHANDIGARH,2009,House Wife,0,17,17
CHANDIGARH,2009,Service (Government),7,0,7
CHANDIGARH,2009,Service (Private),5,1,6
CHANDIGARH,2009,Public Sector Undertaking,12,0,12
CHANDIGARH,2009,Student,6,12,18
CHANDIGARH,2009,Unemployed,7,0,7
CHANDIGARH,2009,Self-employed (Business activity),3,0,3
CHANDIGARH,2009,Professional Activity,1,0,1
CHANDIGARH,2009,Farming/Agriculture Activity,0,0,0
CHANDIGARH,2009,Others (Please Specify),1,0,1
CHANDIGARH,2009,Retired Person,1,0,1
CHANDIGARH,2009,Others (Please Specify),1,1,2
CHANDIGARH,2009,Total,44,31,75
CHANDIGARH,2009,Total Salaried,24,1,25
CHANDIGARH,2009,Total Self-employed,5,0,5
CHANDIGARH,2010,House Wife,0,19,19
CHANDIGARH,2010,Service (Government),3,1,4
CHANDIGARH,2010,Service (Private),10,0,10
CHANDIGARH,2010,Public Sector Undertaking,2,0,2
CHANDIGARH,2010,Student,4,10,14
CHANDIGARH,2010,Unemployed,5,3,8
CHANDIGARH,2010,Self-employed (Business activity),1,0,1
CHANDIGARH,2010,Professional Activity,0,0,0
CHANDIGARH,2010,Farming/Agriculture Activity,0,0,0
CHANDIGARH,2010,Others (Please Specify),5,6,11
CHANDIGARH,2010,Retired Person,1,0,1
CHANDIGARH,2010,Others (Please Specify),0,1,1
CHANDIGARH,2010,Total,31,40,71
CHANDIGARH,2010,Total Salaried,15,1,16
CHANDIGARH,2010,Total Self-employed,6,6,12
CHANDIGARH,2011,House Wife,0,28,28
CHANDIGARH,2011,Service (Government),3,0,3
CHANDIGARH,2011,Service (Private),17,3,20
CHANDIGARH,2011,Public Sector Undertaking,0,0,0
CHANDIGARH,2011,Student,4,10,14
CHANDIGARH,2011,Unemployed,10,2,12
CHANDIGARH,2011,Self-employed (Business activity),3,0,3
CHANDIGARH,2011,Professional Activity,0,0,0
CHANDIGARH,2011,Farming/Agriculture Activity,0,0,0
CHANDIGARH,2011,Others (Please Specify),20,1,21
CHANDIGARH,2011,Retired Person,0,0,0
CHANDIGARH,2011,Others (Please Specify),0,4,4
CHANDIGARH,2011,Total,57,48,105
CHANDIGARH,2011,Total Salaried,20,3,23
CHANDIGARH,2011,Total Self-employed,23,1,24
CHANDIGARH,2012,House Wife,0,18,18
CHANDIGARH,2012,Service (Government),8,0,8
CHANDIGARH,2012,Service (Private),28,1,29
CHANDIGARH,2012,Public Sector Undertaking,4,1,5
CHANDIGARH,2012,Student,5,12,17
CHANDIGARH,2012,Unemployed,12,1,13
CHANDIGARH,2012,Self-employed (Business activity),3,0,3
CHANDIGARH,2012,Professional Activity,0,0,0
CHANDIGARH,2012,Farming/Agriculture Activity,0,0,0
CHANDIGARH,2012,Others (Please Specify),15,3,18
CHANDIGARH,2012,Retired Person,0,0,0
CHANDIGARH,2012,Others (Please Specify),0,3,3
CHANDIGARH,2012,Total,75,39,114
CHANDIGARH,2012,Total Salaried,40,2,42
CHANDIGARH,2012,Total Self-employed,18,3,21
D & N HAVELI,2001,House Wife,0,13,13
D & N HAVELI,2001,Service (Government),0,0,0
D & N HAVELI,2001,Service (Private),5,0,5
D & N HAVELI,2001,Public Sector Undertaking,0,0,0
D & N HAVELI,2001,Student,0,0,0
D & N HAVELI,2001,Unemployed,8,0,8
D & N HAVELI,2001,Self-employed (Business activity),0,0,0
D & N HAVELI,2001,Professional Activity,0,0,0
D & N HAVELI,2001,Farming/Agriculture Activity,19,0,19
D & N HAVELI,2001,Others (Please Specify),2,1,3
D & N HAVELI,2001,Retired Person,0,0,0
D & N HAVELI,2001,Others (Please Specify),1,1,2
D & N HAVELI,2001,Total,35,15,50
D & N HAVELI,2001,Total Salaried,5,0,5
D & N HAVELI,2001,Total Self-employed,21,1,22
D & N HAVELI,2002,House Wife,0,15,15
D & N HAVELI,2002,Service (Government),1,0,1
D & N HAVELI,2002,Service (Private),4,0,4
D & N HAVELI,2002,Public Sector Undertaking,0,0,0
D & N HAVELI,2002,Student,1,3,4
D & N HAVELI,2002,Unemployed,0,0,0
D & N HAVELI,2002,Self-employed (Business activity),0,0,0
D & N HAVELI,2002,Professional Activity,0,0,0
D & N HAVELI,2002,Farming/Agriculture Activity,21,0,21
D & N HAVELI,2002,Others (Please Specify),5,0,5
D & N HAVELI,2002,Retired Person,0,0,0
D & N HAVELI,2002,Others (Please Specify),0,0,0
D & N HAVELI,2002,Total,32,18,50
D & N HAVELI,2002,Total Salaried,5,0,5
D & N HAVELI,2002,Total Self-employed,26,0,26
D & N HAVELI,2003,House Wife,0,21,21
D & N HAVELI,2003,Service (Government),1,0,1
D & N HAVELI,2003,Service (Private),4,0,4
D & N HAVELI,2003,Public Sector Undertaking,0,0,0
D & N HAVELI,2003,Student,1,1,2
D & N HAVELI,2003,Unemployed,0,0,0
D & N HAVELI,2003,Self-employed (Business activity),0,0,0
D & N HAVELI,2003,Professional Activity,0,0,0
D & N HAVELI,2003,Farming/Agriculture Activity,23,0,23
D & N HAVELI,2003,Others (Please Specify),0,0,0
D & N HAVELI,2003,Retired Person,0,0,0
D & N HAVELI,2003,Others (Please Specify),1,0,1
D & N HAVELI,2003,Total,30,22,52
D & N HAVELI,2003,Total Salaried,5,0,5
D & N HAVELI,2003,Total Self-employed,23,0,23
D & N HAVELI,2004,House Wife,0,16,16
D & N HAVELI,2004,Service (Government),0,0,0
D & N HAVELI,2004,Service (Private),4,1,5
D & N HAVELI,2004,Public Sector Undertaking,0,0,0
D & N HAVELI,2004,Student,0,2,2
D & N HAVELI,2004,Unemployed,3,0,3
D & N HAVELI,2004,Self-employed (Business activity),1,0,1
D & N HAVELI,2004,Professional Activity,0,0,0
D & N HAVELI,2004,Farming/Agriculture Activity,7,0,7
D & N HAVELI,2004,Others (Please Specify),5,0,5
D & N HAVELI,2004,Retired Person,0,0,0
D & N HAVELI,2004,Others (Please Specify),0,0,0
D & N HAVELI,2004,Total,20,19,39
D & N HAVELI,2004,Total Salaried,4,1,5
D & N HAVELI,2004,Total Self-employed,13,0,13
D & N HAVELI,2005,House Wife,0,22,22
D & N HAVELI,2005,Service (Government),0,3,3
D & N HAVELI,2005,Service (Private),4,0,4
D & N HAVELI,2005,Public Sector Undertaking,0,0,0
D & N HAVELI,2005,Student,0,0,0
D & N HAVELI,2005,Unemployed,2,0,2
D & N HAVELI,2005,Self-employed (Business activity),0,0,0
D & N HAVELI,2005,Professional Activity,0,0,0
D & N HAVELI,2005,Farming/Agriculture Activity,13,0,13
D & N HAVELI,2005,Others (Please Specify),0,0,0
D & N HAVELI,2005,Retired Person,0,0,0
D & N HAVELI,2005,Others (Please Specify),22,3,25
D & N HAVELI,2005,Total,41,28,69
D & N HAVELI,2005,Total Salaried,4,3,7
D & N HAVELI,2005,Total Self-employed,13,0,13
D & N HAVELI,2006,House Wife,0,17,17
D & N HAVELI,2006,Service (Government),0,0,0
D & N HAVELI,2006,Service (Private),3,0,3
D & N HAVELI,2006,Public Sector Undertaking,0,0,0
D & N HAVELI,2006,Student,2,0,2
D & N HAVELI,2006,Unemployed,5,2,7
D & N HAVELI,2006,Self-employed (Business activity),1,0,1
D & N HAVELI,2006,Professional Activity,0,0,0
D & N HAVELI,2006,Farming/Agriculture Activity,12,0,12
D & N HAVELI,2006,Others (Please Specify),0,0,0
D & N HAVELI,2006,Retired Person,0,0,0
D & N HAVELI,2006,Others (Please Specify),0,0,0
D & N HAVELI,2006,Total,23,19,42
D & N HAVELI,2006,Total Salaried,3,0,3
D & N HAVELI,2006,Total Self-employed,13,0,13
D & N HAVELI,2007,House Wife,0,28,28
D & N HAVELI,2007,Service (Government),0,0,0
D & N HAVELI,2007,Service (Private),8,0,8
D & N HAVELI,2007,Public Sector Undertaking,0,0,0
D & N HAVELI,2007,Student,3,4,7
D & N HAVELI,2007,Unemployed,7,0,7
D & N HAVELI,2007,Self-employed (Business activity),2,0,2
D & N HAVELI,2007,Professional Activity,0,0,0
D & N HAVELI,2007,Farming/Agriculture Activity,17,0,17
D & N HAVELI,2007,Others (Please Specify),0,0,0
D & N HAVELI,2007,Retired Person,5,0,5
D & N HAVELI,2007,Others (Please Specify),2,0,2
D & N HAVELI,2007,Total,44,32,76
D & N HAVELI,2007,Total Salaried,8,0,8
D & N HAVELI,2007,Total Self-employed,19,0,19
D & N HAVELI,2008,House Wife,0,23,23
D & N HAVELI,2008,Service (Government),1,0,1
D & N HAVELI,2008,Service (Private),13,4,17
D & N HAVELI,2008,Public Sector Undertaking,0,0,0
D & N HAVELI,2008,Student,0,1,1
D & N HAVELI,2008,Unemployed,0,0,0
D & N HAVELI,2008,Self-employed (Business activity),1,0,1
D & N HAVELI,2008,Professional Activity,0,0,0
D & N HAVELI,2008,Farming/Agriculture Activity,12,0,12
D & N HAVELI,2008,Others (Please Specify),0,0,0
D & N HAVELI,2008,Retired Person,0,0,0
D & N HAVELI,2008,Others (Please Specify),5,0,5
D & N HAVELI,2008,Total,32,28,60
D & N HAVELI,2008,Total Salaried,14,4,18
D & N HAVELI,2008,Total Self-employed,13,0,13
D & N HAVELI,2009,House Wife,0,19,19
D & N HAVELI,2009,Service (Government),1,0,1
D & N HAVELI,2009,Service (Private),10,2,12
D & N HAVELI,2009,Public Sector Undertaking,0,0,0
D & N HAVELI,2009,Student,2,4,6
D & N HAVELI,2009,Unemployed,0,0,0
D & N HAVELI,2009,Self-employed (Business activity),1,0,1
D & N HAVELI,2009,Professional Activity,0,0,0
D & N HAVELI,2009,Farming/Agriculture Activity,15,0,15
D & N HAVELI,2009,Others (Please Specify),1,1,2
D & N HAVELI,2009,Retired Person,0,0,0
D & N HAVELI,2009,Others (Please Specify),0,0,0
D & N HAVELI,2009,Total,30,26,56
D & N HAVELI,2009,Total Salaried,11,2,13
D & N HAVELI,2009,Total Self-employed,17,1,18
D & N HAVELI,2010,House Wife,0,23,23
D & N HAVELI,2010,Service (Government),1,0,1
D & N HAVELI,2010,Service (Private),12,0,12
D & N HAVELI,2010,Public Sector Undertaking,0,0,0
D & N HAVELI,2010,Student,0,3,3
D & N HAVELI,2010,Unemployed,0,0,0
D & N HAVELI,2010,Self-employed (Business activity),0,0,0
D & N HAVELI,2010,Professional Activity,0,0,0
D & N HAVELI,2010,Farming/Agriculture Activity,10,0,10
D & N HAVELI,2010,Others (Please Specify),1,0,1
D & N HAVELI,2010,Retired Person,0,0,0
D & N HAVELI,2010,Others (Please Specify),13,0,13
D & N HAVELI,2010,Total,37,26,63
D & N HAVELI,2010,Total Salaried,13,0,13
D & N HAVELI,2010,Total Self-employed,11,0,11
D & N HAVELI,2011,House Wife,0,12,12
D & N HAVELI,2011,Service (Government),0,0,0
D & N HAVELI,2011,Service (Private),20,5,25
D & N HAVELI,2011,Public Sector Undertaking,0,0,0
D & N HAVELI,2011,Student,3,3,6
D & N HAVELI,2011,Unemployed,0,0,0
D & N HAVELI,2011,Self-employed (Business activity),2,0,2
D & N HAVELI,2011,Professional Activity,0,0,0
D & N HAVELI,2011,Farming/Agriculture Activity,13,0,13
D & N HAVELI,2011,Others (Please Specify),3,2,5
D & N HAVELI,2011,Retired Person,0,0,0
D & N HAVELI,2011,Others (Please Specify),0,0,0
D & N HAVELI,2011,Total,41,22,63
D & N HAVELI,2011,Total Salaried,20,5,25
D & N HAVELI,2011,Total Self-employed,18,2,20
D & N HAVELI,2012,House Wife,0,13,13
D & N HAVELI,2012,Service (Government),0,0,0
D & N HAVELI,2012,Service (Private),26,2,28
D & N HAVELI,2012,Public Sector Undertaking,0,0,0
D & N HAVELI,2012,Student,0,6,6
D & N HAVELI,2012,Unemployed,2,2,4
D & N HAVELI,2012,Self-employed (Business activity),3,0,3
D & N HAVELI,2012,Professional Activity,0,0,0
D & N HAVELI,2012,Farming/Agriculture Activity,6,0,6
D & N HAVELI,2012,Others (Please Specify),0,0,0
D & N HAVELI,2012,Retired Person,0,0,0
D & N HAVELI,2012,Others (Please Specify),4,2,6
D & N HAVELI,2012,Total,41,25,66
D & N HAVELI,2012,Total Salaried,26,2,28
D & N HAVELI,2012,Total Self-employed,9,0,9
DAMAN & DIU,2001,House Wife,0,3,3
DAMAN & DIU,2001,Service (Government),0,0,0
DAMAN & DIU,2001,Service (Private),5,1,6
DAMAN & DIU,2001,Public Sector Undertaking,0,0,0
DAMAN & DIU,2001,Student,0,0,0
DAMAN & DIU,2001,Unemployed,0,0,0
DAMAN & DIU,2001,Self-employed (Business activity),0,0,0
DAMAN & DIU,2001,Professional Activity,1,0,1
DAMAN & DIU,2001,Farming/Agriculture Activity,0,0,0
DAMAN & DIU,2001,Others (Please Specify),3,0,3
DAMAN & DIU,2001,Retired Person,0,0,0
DAMAN & DIU,2001,Others (Please Specify),1,0,1
DAMAN & DIU,2001,Total,10,4,14
DAMAN & DIU,2001,Total Salaried,5,1,6
DAMAN & DIU,2001,Total Self-employed,4,0,4
DAMAN & DIU,2002,House Wife,0,2,2
DAMAN & DIU,2002,Service (Government),0,0,0
DAMAN & DIU,2002,Service (Private),9,0,9
DAMAN & DIU,2002,Public Sector Undertaking,0,0,0
DAMAN & DIU,2002,Student,0,0,0
DAMAN & DIU,2002,Unemployed,1,0,1
DAMAN & DIU,2002,Self-employed (Business activity),0,0,0
DAMAN & DIU,2002,Professional Activity,0,0,0
DAMAN & DIU,2002,Farming/Agriculture Activity,2,0,2
DAMAN & DIU,2002,Others (Please Specify),0,0,0
DAMAN & DIU,2002,Retired Person,0,0,0
DAMAN & DIU,2002,Others (Please Specify),3,0,3
DAMAN & DIU,2002,Total,15,2,17
DAMAN & DIU,2002,Total Salaried,9,0,9
DAMAN & DIU,2002,Total Self-employed,2,0,2
DAMAN & DIU,2003,House Wife,0,5,5
DAMAN & DIU,2003,Service (Government),0,0,0
DAMAN & DIU,2003,Service (Private),4,0,4
DAMAN & DIU,2003,Public Sector Undertaking,0,0,0
DAMAN & DIU,2003,Student,0,0,0
DAMAN & DIU,2003,Unemployed,3,0,3
DAMAN & DIU,2003,Self-employed (Business activity),1,0,1
DAMAN & DIU,2003,Professional Activity,1,0,1
DAMAN & DIU,2003,Farming/Agriculture Activity,0,0,0
DAMAN & DIU,2003,Others (Please Specify),3,0,3
DAMAN & DIU,2003,Retired Person,0,0,0
DAMAN & DIU,2003,Others (Please Specify),6,1,7
DAMAN & DIU,2003,Total,18,6,24
DAMAN & DIU,2003,Total Salaried,4,0,4
DAMAN & DIU,2003,Total Self-employed,5,0,5
DAMAN & DIU,2004,House Wife,0,5,5
DAMAN & DIU,2004,Service (Government),0,0,0
DAMAN & DIU,2004,Service (Private),1,2,3
DAMAN & DIU,2004,Public Sector Undertaking,0,0,0
DAMAN & DIU,2004,Student,0,0,0
DAMAN & DIU,2004,Unemployed,0,0,0
DAMAN & DIU,2004,Self-employed (Business activity),0,0,0
DAMAN & DIU,2004,Professional Activity,0,0,0
DAMAN & DIU,2004,Farming/Agriculture Activity,2,0,2
DAMAN & DIU,2004,Others (Please Specify),0,0,0
DAMAN & DIU,2004,Retired Person,0,0,0
DAMAN & DIU,2004,Others (Please Specify),2,1,3
DAMAN & DIU,2004,Total,5,8,13
DAMAN & DIU,2004,Total Salaried,1,2,3
DAMAN & DIU,2004,Total Self-employed,2,0,2
DAMAN & DIU,2005,House Wife,0,4,4
DAMAN & DIU,2005,Service (Government),0,0,0
DAMAN & DIU,2005,Service (Private),8,0,8
DAMAN & DIU,2005,Public Sector Undertaking,1,0,1
DAMAN & DIU,2005,Student,1,0,1
DAMAN & DIU,2005,Unemployed,4,0,4
DAMAN & DIU,2005,Self-employed (Business activity),1,0,1
DAMAN & DIU,2005,Professional Activity,0,0,0
DAMAN & DIU,2005,Farming/Agriculture Activity,0,0,0
DAMAN & DIU,2005,Others (Please Specify),8,0,8
DAMAN & DIU,2005,Retired Person,0,0,0
DAMAN & DIU,2005,Others (Please Specify),2,3,5
DAMAN & DIU,2005,Total,25,7,32
DAMAN & DIU,2005,Total Salaried,9,0,9
DAMAN & DIU,2005,Total Self-employed,9,0,9
DAMAN & DIU,2006,House Wife,0,3,3
DAMAN & DIU,2006,Service (Government),0,0,0
DAMAN & DIU,2006,Service (Private),8,0,8
DAMAN & DIU,2006,Public Sector Undertaking,0,0,0
DAMAN & DIU,2006,Student,1,2,3
DAMAN & DIU,2006,Unemployed,0,0,0
DAMAN & DIU,2006,Self-employed (Business activity),1,0,1
DAMAN & DIU,2006,Professional Activity,0,0,0
DAMAN & DIU,2006,Farming/Agriculture Activity,0,0,0
DAMAN & DIU,2006,Others (Please Specify),2,0,2
DAMAN & DIU,2006,Retired Person,0,0,0
DAMAN & DIU,2006,Others (Please Specify),2,3,5
DAMAN & DIU,2006,Total,14,8,22
DAMAN & DIU,2006,Total Salaried,8,0,8
DAMAN & DIU,2006,Total Self-employed,3,0,3
DAMAN & DIU,2007,House Wife,0,5,5
DAMAN & DIU,2007,Service (Government),2,0,2
DAMAN & DIU,2007,Service (Private),4,1,5
DAMAN & DIU,2007,Public Sector Undertaking,0,0,0
DAMAN & DIU,2007,Student,0,0,0
DAMAN & DIU,2007,Unemployed,0,0,0
DAMAN & DIU,2007,Self-employed (Business activity),0,0,0
DAMAN & DIU,2007,Professional Activity,0,0,0
DAMAN & DIU,2007,Farming/Agriculture Activity,0,0,0
DAMAN & DIU,2007,Others (Please Specify),0,0,0
DAMAN & DIU,2007,Retired Person,0,0,0
DAMAN & DIU,2007,Others (Please Specify),0,3,3
DAMAN & DIU,2007,Total,6,9,15
DAMAN & DIU,2007,Total Salaried,6,1,7
DAMAN & DIU,2007,Total Self-employed,0,0,0
DAMAN & DIU,2008,House Wife,0,0,0
DAMAN & DIU,2008,Service (Government),1,0,1
DAMAN & DIU,2008,Service (Private),8,0,8
DAMAN & DIU,2008,Public Sector Undertaking,0,0,0
DAMAN & DIU,2008,Student,0,0,0
DAMAN & DIU,2008,Unemployed,2,1,3
DAMAN & DIU,2008,Self-employed (Business activity),1,0,1
DAMAN & DIU,2008,Professional Activity,0,0,0
DAMAN & DIU,2008,Farming/Agriculture Activity,0,0,0
DAMAN & DIU,2008,Others (Please Specify),1,0,1
DAMAN & DIU,2008,Retired Person,0,0,0
DAMAN & DIU,2008,Others (Please Specify),1,4,5
DAMAN & DIU,2008,Total,14,5,19
DAMAN & DIU,2008,Total Salaried,9,0,9
DAMAN & DIU,2008,Total Self-employed,2,0,2
DAMAN & DIU,2009,House Wife,0,4,4
DAMAN & DIU,2009,Service (Government),0,0,0
DAMAN & DIU,2009,Service (Private),6,1,7
DAMAN & DIU,2009,Public Sector Undertaking,0,1,1
DAMAN & DIU,2009,Student,2,1,3
DAMAN & DIU,2009,Unemployed,1,0,1
DAMAN & DIU,2009,Self-employed (Business activity),0,0,0
DAMAN & DIU,2009,Professional Activity,0,0,0
DAMAN & DIU,2009,Farming/Agriculture Activity,0,0,0
DAMAN & DIU,2009,Others (Please Specify),0,0,0
DAMAN & DIU,2009,Retired Person,0,0,0
DAMAN & DIU,2009,Others (Please Specify),6,1,7
DAMAN & DIU,2009,Total,15,8,23
DAMAN & DIU,2009,Total Salaried,6,2,8
DAMAN & DIU,2009,Total Self-employed,0,0,0
DAMAN & DIU,2010,House Wife,0,8,8
DAMAN & DIU,2010,Service (Government),1,0,1
DAMAN & DIU,2010,Service (Private),10,1,11
DAMAN & DIU,2010,Public Sector Undertaking,0,0,0
DAMAN & DIU,2010,Student,5,1,6
DAMAN & DIU,2010,Unemployed,0,0,0
DAMAN & DIU,2010,Self-employed (Business activity),0,0,0
DAMAN & DIU,2010,Professional Activity,0,0,0
DAMAN & DIU,2010,Farming/Agriculture Activity,0,0,0
DAMAN & DIU,2010,Others (Please Specify),0,0,0
DAMAN & DIU,2010,Retired Person,0,0,0
DAMAN & DIU,2010,Others (Please Specify),3,2,5
DAMAN & DIU,2010,Total,19,12,31
DAMAN & DIU,2010,Total Salaried,11,1,12
DAMAN & DIU,2010,Total Self-employed,0,0,0
DAMAN & DIU,2011,House Wife,0,7,7
DAMAN & DIU,2011,Service (Government),0,0,0
DAMAN & DIU,2011,Service (Private),13,3,16
DAMAN & DIU,2011,Public Sector Undertaking,0,0,0
DAMAN & DIU,2011,Student,1,4,5
DAMAN & DIU,2011,Unemployed,0,0,0
DAMAN & DIU,2011,Self-employed (Business activity),0,0,0
DAMAN & DIU,2011,Professional Activity,0,0,0
DAMAN & DIU,2011,Farming/Agriculture Activity,0,0,0
DAMAN & DIU,2011,Others (Please Specify),1,0,1
DAMAN & DIU,2011,Retired Person,0,0,0
DAMAN & DIU,2011,Others (Please Specify),3,1,4
DAMAN & DIU,2011,Total,18,15,33
DAMAN & DIU,2011,Total Salaried,13,3,16
DAMAN & DIU,2011,Total Self-employed,1,0,1
DAMAN & DIU,2012,House Wife,0,8,8
DAMAN & DIU,2012,Service (Government),0,0,0
DAMAN & DIU,2012,Service (Private),8,0,8
DAMAN & DIU,2012,Public Sector Undertaking,0,0,0
DAMAN & DIU,2012,Student,1,1,2
DAMAN & DIU,2012,Unemployed,1,0,1
DAMAN & DIU,2012,Self-employed (Business activity),0,0,0
DAMAN & DIU,2012,Professional Activity,0,0,0
DAMAN & DIU,2012,Farming/Agriculture Activity,0,0,0
DAMAN & DIU,2012,Others (Please Specify),1,0,1
DAMAN & DIU,2012,Retired Person,0,0,0
DAMAN & DIU,2012,Others (Please Specify),14,2,16
DAMAN & DIU,2012,Total,25,11,36
DAMAN & DIU,2012,Total Salaried,8,0,8
DAMAN & DIU,2012,Total Self-employed,1,0,1
DELHI (UT),2001,House Wife,0,327,327
DELHI (UT),2001,Service (Government),29,2,31
DELHI (UT),2001,Service (Private),147,13,160
DELHI (UT),2001,Public Sector Undertaking,19,1,20
DELHI (UT),2001,Student,55,49,104
DELHI (UT),2001,Unemployed,209,20,229
DELHI (UT),2001,Self-employed (Business activity),23,0,23
DELHI (UT),2001,Professional Activity,11,1,12
DELHI (UT),2001,Farming/Agriculture Activity,16,2,18
DELHI (UT),2001,Others (Please Specify),186,84,270
DELHI (UT),2001,Retired Person,1,0,1
DELHI (UT),2001,Others (Please Specify),34,10,44
DELHI (UT),2001,Total,730,509,1239
DELHI (UT),2001,Total Salaried,195,16,211
DELHI (UT),2001,Total Self-employed,236,87,323
DELHI (UT),2002,House Wife,0,250,250
DELHI (UT),2002,Service (Government),26,6,32
DELHI (UT),2002,Service (Private),122,14,136
DELHI (UT),2002,Public Sector Undertaking,9,0,9
DELHI (UT),2002,Student,47,58,105
DELHI (UT),2002,Unemployed,233,27,260
DELHI (UT),2002,Self-employed (Business activity),42,4,46
DELHI (UT),2002,Professional Activity,11,0,11
DELHI (UT),2002,Farming/Agriculture Activity,30,3,33
DELHI (UT),2002,Others (Please Specify),93,37,130
DELHI (UT),2002,Retired Person,6,0,6
DELHI (UT),2002,Others (Please Specify),24,11,35
DELHI (UT),2002,Total,643,410,1053
DELHI (UT),2002,Total Salaried,157,20,177
DELHI (UT),2002,Total Self-employed,176,44,220
DELHI (UT),2003,House Wife,0,221,221
DELHI (UT),2003,Service (Government),18,13,31
DELHI (UT),2003,Service (Private),108,20,128
DELHI (UT),2003,Public Sector Undertaking,10,1,11
DELHI (UT),2003,Student,52,65,117
DELHI (UT),2003,Unemployed,253,41,294
DELHI (UT),2003,Self-employed (Business activity),25,0,25
DELHI (UT),2003,Professional Activity,7,0,7
DELHI (UT),2003,Farming/Agriculture Activity,8,0,8
DELHI (UT),2003,Others (Please Specify),130,27,157
DELHI (UT),2003,Retired Person,0,0,0
DELHI (UT),2003,Others (Please Specify),130,24,154
DELHI (UT),2003,Total,741,412,1153
DELHI (UT),2003,Total Salaried,136,34,170
DELHI (UT),2003,Total Self-employed,170,27,197
DELHI (UT),2004,House Wife,0,266,266
DELHI (UT),2004,Service (Government),14,0,14
DELHI (UT),2004,Service (Private),199,6,205
DELHI (UT),2004,Public Sector Undertaking,11,4,15
DELHI (UT),2004,Student,57,53,110
DELHI (UT),2004,Unemployed,254,66,320
DELHI (UT),2004,Self-employed (Business activity),31,0,31
DELHI (UT),2004,Professional Activity,5,0,5
DELHI (UT),2004,Farming/Agriculture Activity,12,1,13
DELHI (UT),2004,Others (Please Specify),148,43,191
DELHI (UT),2004,Retired Person,2,0,2
DELHI (UT),2004,Others (Please Specify),66,18,84
DELHI (UT),2004,Total,799,457,1256
DELHI (UT),2004,Total Salaried,224,10,234
DELHI (UT),2004,Total Self-employed,196,44,240
DELHI (UT),2005,House Wife,0,294,294
DELHI (UT),2005,Service (Government),36,4,40
DELHI (UT),2005,Service (Private),165,18,183
DELHI (UT),2005,Public Sector Undertaking,4,1,5
DELHI (UT),2005,Student,59,39,98
DELHI (UT),2005,Unemployed,209,32,241
DELHI (UT),2005,Self-employed (Business activity),16,0,16
DELHI (UT),2005,Professional Activity,5,1,6
DELHI (UT),2005,Farming/Agriculture Activity,7,0,7
DELHI (UT),2005,Others (Please Specify),122,24,146
DELHI (UT),2005,Retired Person,3,0,3
DELHI (UT),2005,Others (Please Specify),151,55,206
DELHI (UT),2005,Total,777,468,1245
DELHI (UT),2005,Total Salaried,205,23,228
DELHI (UT),2005,Total Self-employed,150,25,175
DELHI (UT),2006,House Wife,0,331,331
DELHI (UT),2006,Service (Government),27,4,31
DELHI (UT),2006,Service (Private),248,17,265
DELHI (UT),2006,Public Sector Undertaking,22,3,25
DELHI (UT),2006,Student,55,63,118
DELHI (UT),2006,Unemployed,277,40,317
DELHI (UT),2006,Self-employed (Business activity),22,7,29
DELHI (UT),2006,Professional Activity,4,0,4
DELHI (UT),2006,Farming/Agriculture Activity,3,0,3
DELHI (UT),2006,Others (Please Specify),211,48,259
DELHI (UT),2006,Retired Person,17,0,17
DELHI (UT),2006,Others (Please Specify),74,19,93
DELHI (UT),2006,Total,960,532,1492
DELHI (UT),2006,Total Salaried,297,24,321
DELHI (UT),2006,Total Self-employed,240,55,295
DELHI (UT),2007,House Wife,0,263,263
DELHI (UT),2007,Service (Government),24,4,28
DELHI (UT),2007,Service (Private),219,29,248
DELHI (UT),2007,Public Sector Undertaking,12,2,14
DELHI (UT),2007,Student,75,60,135
DELHI (UT),2007,Unemployed,202,50,252
DELHI (UT),2007,Self-employed (Business activity),17,0,17
DELHI (UT),2007,Professional Activity,4,1,5
DELHI (UT),2007,Farming/Agriculture Activity,23,0,23
DELHI (UT),2007,Others (Please Specify),149,32,181
DELHI (UT),2007,Retired Person,5,0,5
DELHI (UT),2007,Others (Please Specify),236,74,310
DELHI (UT),2007,Total,966,515,1481
DELHI (UT),2007,Total Salaried,255,35,290
DELHI (UT),2007,Total Self-employed,193,33,226
DELHI (UT),2008,House Wife,0,276,276
DELHI (UT),2008,Service (Government),13,2,15
DELHI (UT),2008,Service (Private),186,27,213
DELHI (UT),2008,Public Sector Undertaking,35,3,38
DELHI (UT),2008,Student,77,98,175
DELHI (UT),2008,Unemployed,211,41,252
DELHI (UT),2008,Self-employed (Business activity),21,0,21
DELHI (UT),2008,Professional Activity,7,0,7
DELHI (UT),2008,Farming/Agriculture Activity,15,1,16
DELHI (UT),2008,Others (Please Specify),146,25,171
DELHI (UT),2008,Retired Person,2,0,2
DELHI (UT),2008,Others (Please Specify),82,35,117
DELHI (UT),2008,Total,795,508,1303
DELHI (UT),2008,Total Salaried,234,32,266
DELHI (UT),2008,Total Self-employed,189,26,215
DELHI (UT),2009,House Wife,0,323,323
DELHI (UT),2009,Service (Government),18,2,20
DELHI (UT),2009,Service (Private),210,21,231
DELHI (UT),2009,Public Sector Undertaking,24,2,26
DELHI (UT),2009,Student,99,66,165
DELHI (UT),2009,Unemployed,238,42,280
DELHI (UT),2009,Self-employed (Business activity),31,0,31
DELHI (UT),2009,Professional Activity,12,1,13
DELHI (UT),2009,Farming/Agriculture Activity,5,0,5
DELHI (UT),2009,Others (Please Specify),108,24,132
DELHI (UT),2009,Retired Person,7,0,7
DELHI (UT),2009,Others (Please Specify),181,63,244
DELHI (UT),2009,Total,933,544,1477
DELHI (UT),2009,Total Salaried,252,25,277
DELHI (UT),2009,Total Self-employed,156,25,181
DELHI (UT),2010,House Wife,0,352,352
DELHI (UT),2010,Service (Government),15,3,18
DELHI (UT),2010,Service (Private),201,22,223
DELHI (UT),2010,Public Sector Undertaking,39,5,44
DELHI (UT),2010,Student,87,79,166
DELHI (UT),2010,Unemployed,236,43,279
DELHI (UT),2010,Self-employed (Business activity),32,0,32
DELHI (UT),2010,Professional Activity,3,1,4
DELHI (UT),2010,Farming/Agriculture Activity,9,0,9
DELHI (UT),2010,Others (Please Specify),176,37,213
DELHI (UT),2010,Retired Person,4,0,4
DELHI (UT),2010,Others (Please Specify),159,40,199
DELHI (UT),2010,Total,961,582,1543
DELHI (UT),2010,Total Salaried,255,30,285
DELHI (UT),2010,Total Self-employed,220,38,258
DELHI (UT),2011,House Wife,0,290,290
DELHI (UT),2011,Service (Government),27,6,33
DELHI (UT),2011,Service (Private),227,28,255
DELHI (UT),2011,Public Sector Undertaking,29,1,30
DELHI (UT),2011,Student,114,86,200
DELHI (UT),2011,Unemployed,370,55,425
DELHI (UT),2011,Self-employed (Business activity),26,1,27
DELHI (UT),2011,Professional Activity,13,0,13
DELHI (UT),2011,Farming/Agriculture Activity,10,0,10
DELHI (UT),2011,Others (Please Specify),144,31,175
DELHI (UT),2011,Retired Person,11,0,11
DELHI (UT),2011,Others (Please Specify),197,50,247
DELHI (UT),2011,Total,1168,548,1716
DELHI (UT),2011,Total Salaried,283,35,318
DELHI (UT),2011,Total Self-employed,193,32,225
DELHI (UT),2012,House Wife,0,355,355
DELHI (UT),2012,Service (Government),24,1,25
DELHI (UT),2012,Service (Private),264,16,280
DELHI (UT),2012,Public Sector Undertaking,38,3,41
DELHI (UT),2012,Student,137,129,266
DELHI (UT),2012,Unemployed,320,49,369
DELHI (UT),2012,Self-employed (Business activity),44,0,44
DELHI (UT),2012,Professional Activity,7,3,10
DELHI (UT),2012,Farming/Agriculture Activity,21,0,21
DELHI (UT),2012,Others (Please Specify),167,25,192
DELHI (UT),2012,Retired Person,17,0,17
DELHI (UT),2012,Others (Please Specify),207,72,279
DELHI (UT),2012,Total,1246,653,1899
DELHI (UT),2012,Total Salaried,326,20,346
DELHI (UT),2012,Total Self-employed,239,28,267
LAKSHADWEEP,2001,House Wife,0,0,0
LAKSHADWEEP,2001,Service (Government),0,0,0
LAKSHADWEEP,2001,Service (Private),0,0,0
LAKSHADWEEP,2001,Public Sector Undertaking,0,0,0
LAKSHADWEEP,2001,Student,0,0,0
LAKSHADWEEP,2001,Unemployed,0,0,0
LAKSHADWEEP,2001,Self-employed (Business activity),0,0,0
LAKSHADWEEP,2001,Professional Activity,0,0,0
LAKSHADWEEP,2001,Farming/Agriculture Activity,0,0,0
LAKSHADWEEP,2001,Others (Please Specify),0,0,0
LAKSHADWEEP,2001,Retired Person,0,0,0
LAKSHADWEEP,2001,Others (Please Specify),0,0,0
LAKSHADWEEP,2001,Total,0,0,0
LAKSHADWEEP,2001,Total Salaried,0,0,0
LAKSHADWEEP,2001,Total Self-employed,0,0,0
LAKSHADWEEP,2002,House Wife,0,0,0
LAKSHADWEEP,2002,Service (Government),0,0,0
LAKSHADWEEP,2002,Service (Private),0,0,0
LAKSHADWEEP,2002,Public Sector Undertaking,0,0,0
LAKSHADWEEP,2002,Student,0,0,0
LAKSHADWEEP,2002,Unemployed,0,0,0
LAKSHADWEEP,2002,Self-employed (Business activity),0,0,0
LAKSHADWEEP,2002,Professional Activity,0,0,0
LAKSHADWEEP,2002,Farming/Agriculture Activity,0,0,0
LAKSHADWEEP,2002,Others (Please Specify),0,0,0
LAKSHADWEEP,2002,Retired Person,0,0,0
LAKSHADWEEP,2002,Others (Please Specify),0,0,0
LAKSHADWEEP,2002,Total,0,0,0
LAKSHADWEEP,2002,Total Salaried,0,0,0
LAKSHADWEEP,2002,Total Self-employed,0,0,0
LAKSHADWEEP,2003,House Wife,0,1,1
LAKSHADWEEP,2003,Service (Government),0,0,0
LAKSHADWEEP,2003,Service (Private),0,0,0
LAKSHADWEEP,2003,Public Sector Undertaking,0,0,0
LAKSHADWEEP,2003,Student,0,0,0
LAKSHADWEEP,2003,Unemployed,0,0,0
LAKSHADWEEP,2003,Self-employed (Business activity),0,0,0
LAKSHADWEEP,2003,Professional Activity,0,0,0
LAKSHADWEEP,2003,Farming/Agriculture Activity,0,0,0
LAKSHADWEEP,2003,Others (Please Specify),0,0,0
LAKSHADWEEP,2003,Retired Person,0,0,0
LAKSHADWEEP,2003,Others (Please Specify),1,0,1
LAKSHADWEEP,2003,Total,1,1,2
LAKSHADWEEP,2003,Total Salaried,0,0,0
LAKSHADWEEP,2003,Total Self-employed,0,0,0
LAKSHADWEEP,2004,House Wife,0,0,0
LAKSHADWEEP,2004,Service (Government),0,0,0
LAKSHADWEEP,2004,Service (Private),0,0,0
LAKSHADWEEP,2004,Public Sector Undertaking,0,0,0
LAKSHADWEEP,2004,Student,0,0,0
LAKSHADWEEP,2004,Unemployed,0,0,0
LAKSHADWEEP,2004,Self-employed (Business activity),0,0,0
LAKSHADWEEP,2004,Professional Activity,0,0,0
LAKSHADWEEP,2004,Farming/Agriculture Activity,0,0,0
LAKSHADWEEP,2004,Others (Please Specify),0,0,0
LAKSHADWEEP,2004,Retired Person,0,0,0
LAKSHADWEEP,2004,Others (Please Specify),0,0,0
LAKSHADWEEP,2004,Total,0,0,0
LAKSHADWEEP,2004,Total Salaried,0,0,0
LAKSHADWEEP,2004,Total Self-employed,0,0,0
LAKSHADWEEP,2005,House Wife,0,0,0
LAKSHADWEEP,2005,Service (Government),0,0,0
LAKSHADWEEP,2005,Service (Private),0,0,0
LAKSHADWEEP,2005,Public Sector Undertaking,0,0,0
LAKSHADWEEP,2005,Student,0,0,0
LAKSHADWEEP,2005,Unemployed,0,0,0
LAKSHADWEEP,2005,Self-employed (Business activity),0,0,0
LAKSHADWEEP,2005,Professional Activity,0,0,0
LAKSHADWEEP,2005,Farming/Agriculture Activity,0,0,0
LAKSHADWEEP,2005,Others (Please Specify),0,0,0
LAKSHADWEEP,2005,Retired Person,0,0,0
LAKSHADWEEP,2005,Others (Please Specify),0,0,0
LAKSHADWEEP,2005,Total,0,0,0
LAKSHADWEEP,2005,Total Salaried,0,0,0
LAKSHADWEEP,2005,Total Self-employed,0,0,0
LAKSHADWEEP,2006,House Wife,0,1,1
LAKSHADWEEP,2006,Service (Government),1,0,1
LAKSHADWEEP,2006,Service (Private),0,0,0
LAKSHADWEEP,2006,Public Sector Undertaking,0,0,0
LAKSHADWEEP,2006,Student,0,0,0
LAKSHADWEEP,2006,Unemployed,0,0,0
LAKSHADWEEP,2006,Self-employed (Business activity),0,0,0
LAKSHADWEEP,2006,Professional Activity,0,0,0
LAKSHADWEEP,2006,Farming/Agriculture Activity,0,0,0
LAKSHADWEEP,2006,Others (Please Specify),0,0,0
LAKSHADWEEP,2006,Retired Person,0,0,0
LAKSHADWEEP,2006,Others (Please Specify),0,0,0
LAKSHADWEEP,2006,Total,1,1,2
LAKSHADWEEP,2006,Total Salaried,1,0,1
LAKSHADWEEP,2006,Total Self-employed,0,0,0
LAKSHADWEEP,2007,House Wife,0,2,2
LAKSHADWEEP,2007,Service (Government),1,0,1
LAKSHADWEEP,2007,Service (Private),0,0,0
LAKSHADWEEP,2007,Public Sector Undertaking,0,0,0
LAKSHADWEEP,2007,Student,0,0,0
LAKSHADWEEP,2007,Unemployed,0,0,0
LAKSHADWEEP,2007,Self-employed (Business activity),0,0,0
LAKSHADWEEP,2007,Professional Activity,0,0,0
LAKSHADWEEP,2007,Farming/Agriculture Activity,0,0,0
LAKSHADWEEP,2007,Others (Please Specify),0,0,0
LAKSHADWEEP,2007,Retired Person,0,0,0
LAKSHADWEEP,2007,Others (Please Specify),0,0,0
LAKSHADWEEP,2007,Total,1,2,3
LAKSHADWEEP,2007,Total Salaried,1,0,1
LAKSHADWEEP,2007,Total Self-employed,0,0,0
LAKSHADWEEP,2008,House Wife,0,0,0
LAKSHADWEEP,2008,Service (Government),0,0,0
LAKSHADWEEP,2008,Service (Private),0,0,0
LAKSHADWEEP,2008,Public Sector Undertaking,0,0,0
LAKSHADWEEP,2008,Student,0,0,0
LAKSHADWEEP,2008,Unemployed,0,0,0
LAKSHADWEEP,2008,Self-employed (Business activity),0,0,0
LAKSHADWEEP,2008,Professional Activity,0,0,0
LAKSHADWEEP,2008,Farming/Agriculture Activity,0,0,0
LAKSHADWEEP,2008,Others (Please Specify),0,0,0
LAKSHADWEEP,2008,Retired Person,0,0,0
LAKSHADWEEP,2008,Others (Please Specify),0,0,0
LAKSHADWEEP,2008,Total,0,0,0
LAKSHADWEEP,2008,Total Salaried,0,0,0
LAKSHADWEEP,2008,Total Self-employed,0,0,0
LAKSHADWEEP,2009,House Wife,0,1,1
LAKSHADWEEP,2009,Service (Government),0,0,0
LAKSHADWEEP,2009,Service (Private),0,0,0
LAKSHADWEEP,2009,Public Sector Undertaking,0,0,0
LAKSHADWEEP,2009,Student,0,0,0
LAKSHADWEEP,2009,Unemployed,0,0,0
LAKSHADWEEP,2009,Self-employed (Business activity),0,0,0
LAKSHADWEEP,2009,Professional Activity,0,0,0
LAKSHADWEEP,2009,Farming/Agriculture Activity,0,0,0
LAKSHADWEEP,2009,Others (Please Specify),0,0,0
LAKSHADWEEP,2009,Retired Person,0,0,0
LAKSHADWEEP,2009,Others (Please Specify),0,0,0
LAKSHADWEEP,2009,Total,0,1,1
LAKSHADWEEP,2009,Total Salaried,0,0,0
LAKSHADWEEP,2009,Total Self-employed,0,0,0
LAKSHADWEEP,2010,House Wife,0,1,1
LAKSHADWEEP,2010,Service (Government),0,0,0
LAKSHADWEEP,2010,Service (Private),0,0,0
LAKSHADWEEP,2010,Public Sector Undertaking,0,0,0
LAKSHADWEEP,2010,Student,0,0,0
LAKSHADWEEP,2010,Unemployed,0,0,0
LAKSHADWEEP,2010,Self-employed (Business activity),0,0,0
LAKSHADWEEP,2010,Professional Activity,0,0,0
LAKSHADWEEP,2010,Farming/Agriculture Activity,0,0,0
LAKSHADWEEP,2010,Others (Please Specify),0,0,0
LAKSHADWEEP,2010,Retired Person,0,0,0
LAKSHADWEEP,2010,Others (Please Specify),0,0,0
LAKSHADWEEP,2010,Total,0,1,1
LAKSHADWEEP,2010,Total Salaried,0,0,0
LAKSHADWEEP,2010,Total Self-employed,0,0,0
LAKSHADWEEP,2011,House Wife,0,0,0
LAKSHADWEEP,2011,Service (Government),0,0,0
LAKSHADWEEP,2011,Service (Private),0,0,0
LAKSHADWEEP,2011,Public Sector Undertaking,0,0,0
LAKSHADWEEP,2011,Student,0,0,0
LAKSHADWEEP,2011,Unemployed,0,0,0
LAKSHADWEEP,2011,Self-employed (Business activity),0,0,0
LAKSHADWEEP,2011,Professional Activity,0,0,0
LAKSHADWEEP,2011,Farming/Agriculture Activity,0,0,0
LAKSHADWEEP,2011,Others (Please Specify),0,0,0
LAKSHADWEEP,2011,Retired Person,0,0,0
LAKSHADWEEP,2011,Others (Please Specify),0,0,0
LAKSHADWEEP,2011,Total,0,0,0
LAKSHADWEEP,2011,Total Salaried,0,0,0
LAKSHADWEEP,2011,Total Self-employed,0,0,0
LAKSHADWEEP,2012,House Wife,0,0,0
LAKSHADWEEP,2012,Service (Government),0,0,0
LAKSHADWEEP,2012,Service (Private),0,0,0
LAKSHADWEEP,2012,Public Sector Undertaking,0,0,0
LAKSHADWEEP,2012,Student,0,0,0
LAKSHADWEEP,2012,Unemployed,0,0,0
LAKSHADWEEP,2012,Self-employed (Business activity),0,0,0
LAKSHADWEEP,2012,Professional Activity,0,0,0
LAKSHADWEEP,2012,Farming/Agriculture Activity,0,0,0
LAKSHADWEEP,2012,Others (Please Specify),0,0,0
LAKSHADWEEP,2012,Retired Person,0,0,0
LAKSHADWEEP,2012,Others (Please Specify),1,0,1
LAKSHADWEEP,2012,Total,1,0,1
LAKSHADWEEP,2012,Total Salaried,0,0,0
LAKSHADWEEP,2012,Total Self-employed,0,0,0
PUDUCHERRY,2001,House Wife,0,134,134
PUDUCHERRY,2001,Service (Government),5,1,6
PUDUCHERRY,2001,Service (Private),94,6,100
PUDUCHERRY,2001,Public Sector Undertaking,4,1,5
PUDUCHERRY,2001,Student,9,22,31
PUDUCHERRY,2001,Unemployed,51,32,83
PUDUCHERRY,2001,Self-employed (Business activity),17,0,17
PUDUCHERRY,2001,Professional Activity,0,0,0
PUDUCHERRY,2001,Farming/Agriculture Activity,83,8,91
PUDUCHERRY,2001,Others (Please Specify),60,2,62
PUDUCHERRY,2001,Retired Person,0,0,0
PUDUCHERRY,2001,Others (Please Specify),0,0,0
PUDUCHERRY,2001,Total,323,206,529
PUDUCHERRY,2001,Total Salaried,103,8,111
PUDUCHERRY,2001,Total Self-employed,160,10,170
PUDUCHERRY,2002,House Wife,0,103,103
PUDUCHERRY,2002,Service (Government),18,1,19
PUDUCHERRY,2002,Service (Private),203,10,213
PUDUCHERRY,2002,Public Sector Undertaking,7,0,7
PUDUCHERRY,2002,Student,13,15,28
PUDUCHERRY,2002,Unemployed,40,20,60
PUDUCHERRY,2002,Self-employed (Business activity),18,0,18
PUDUCHERRY,2002,Professional Activity,0,0,0
PUDUCHERRY,2002,Farming/Agriculture Activity,83,5,88
PUDUCHERRY,2002,Others (Please Specify),24,0,24
PUDUCHERRY,2002,Retired Person,4,3,7
PUDUCHERRY,2002,Others (Please Specify),0,0,0
PUDUCHERRY,2002,Total,410,157,567
PUDUCHERRY,2002,Total Salaried,228,11,239
PUDUCHERRY,2002,Total Self-employed,125,5,130
PUDUCHERRY,2003,House Wife,0,108,108
PUDUCHERRY,2003,Service (Government),8,2,10
PUDUCHERRY,2003,Service (Private),17,10,27
PUDUCHERRY,2003,Public Sector Undertaking,11,0,11
PUDUCHERRY,2003,Student,15,15,30
PUDUCHERRY,2003,Unemployed,45,42,87
PUDUCHERRY,2003,Self-employed (Business activity),20,1,21
PUDUCHERRY,2003,Professional Activity,73,1,74
PUDUCHERRY,2003,Farming/Agriculture Activity,21,2,23
PUDUCHERRY,2003,Others (Please Specify),174,13,187
PUDUCHERRY,2003,Retired Person,0,0,0
PUDUCHERRY,2003,Others (Please Specify),4,0,4
PUDUCHERRY,2003,Total,388,194,582
PUDUCHERRY,2003,Total Salaried,36,12,48
PUDUCHERRY,2003,Total Self-employed,288,17,305
PUDUCHERRY,2004,House Wife,0,105,105
PUDUCHERRY,2004,Service (Government),19,4,23
PUDUCHERRY,2004,Service (Private),28,3,31
PUDUCHERRY,2004,Public Sector Undertaking,0,0,0
PUDUCHERRY,2004,Student,8,21,29
PUDUCHERRY,2004,Unemployed,58,39,97
PUDUCHERRY,2004,Self-employed (Business activity),19,1,20
PUDUCHERRY,2004,Professional Activity,25,0,25
PUDUCHERRY,2004,Farming/Agriculture Activity,119,26,145
PUDUCHERRY,2004,Others (Please Specify),13,1,14
PUDUCHERRY,2004,Retired Person,4,0,4
PUDUCHERRY,2004,Others (Please Specify),45,1,46
PUDUCHERRY,2004,Total,338,201,539
PUDUCHERRY,2004,Total Salaried,47,7,54
PUDUCHERRY,2004,Total Self-employed,176,28,204
PUDUCHERRY,2005,House Wife,0,126,126
PUDUCHERRY,2005,Service (Government),12,1,13
PUDUCHERRY,2005,Service (Private),75,11,86
PUDUCHERRY,2005,Public Sector Undertaking,2,0,2
PUDUCHERRY,2005,Student,7,16,23
PUDUCHERRY,2005,Unemployed,71,41,112
PUDUCHERRY,2005,Self-employed (Business activity),10,0,10
PUDUCHERRY,2005,Professional Activity,8,0,8
PUDUCHERRY,2005,Farming/Agriculture Activity,144,3,147
PUDUCHERRY,2005,Others (Please Specify),0,0,0
PUDUCHERRY,2005,Retired Person,4,0,4
PUDUCHERRY,2005,Others (Please Specify),7,0,7
PUDUCHERRY,2005,Total,340,198,538
PUDUCHERRY,2005,Total Salaried,89,12,101
PUDUCHERRY,2005,Total Self-employed,162,3,165
PUDUCHERRY,2006,House Wife,0,96,96
PUDUCHERRY,2006,Service (Government),17,3,20
PUDUCHERRY,2006,Service (Private),64,7,71
PUDUCHERRY,2006,Public Sector Undertaking,4,0,4
PUDUCHERRY,2006,Student,15,37,52
PUDUCHERRY,2006,Unemployed,45,28,73
PUDUCHERRY,2006,Self-employed (Business activity),21,0,21
PUDUCHERRY,2006,Professional Activity,0,0,0
PUDUCHERRY,2006,Farming/Agriculture Activity,169,6,175
PUDUCHERRY,2006,Others (Please Specify),1,0,1
PUDUCHERRY,2006,Retired Person,2,0,2
PUDUCHERRY,2006,Others (Please Specify),11,0,11
PUDUCHERRY,2006,Total,349,177,526
PUDUCHERRY,2006,Total Salaried,85,10,95
PUDUCHERRY,2006,Total Self-employed,191,6,197
PUDUCHERRY,2007,House Wife,0,78,78
PUDUCHERRY,2007,Service (Government),10,4,14
PUDUCHERRY,2007,Service (Private),20,8,28
PUDUCHERRY,2007,Public Sector Undertaking,0,0,0
PUDUCHERRY,2007,Student,9,24,33
PUDUCHERRY,2007,Unemployed,68,63,131
PUDUCHERRY,2007,Self-employed (Business activity),20,0,20
PUDUCHERRY,2007,Professional Activity,0,0,0
PUDUCHERRY,2007,Farming/Agriculture Activity,181,16,197
PUDUCHERRY,2007,Others (Please Specify),0,5,5
PUDUCHERRY,2007,Retired Person,0,0,0
PUDUCHERRY,2007,Others (Please Specify),11,0,11
PUDUCHERRY,2007,Total,319,198,517
PUDUCHERRY,2007,Total Salaried,30,12,42
PUDUCHERRY,2007,Total Self-employed,201,21,222
PUDUCHERRY,2008,House Wife,0,97,97
PUDUCHERRY,2008,Service (Government),9,6,15
PUDUCHERRY,2008,Service (Private),9,2,11
PUDUCHERRY,2008,Public Sector Undertaking,0,3,3
PUDUCHERRY,2008,Student,15,9,24
PUDUCHERRY,2008,Unemployed,62,41,103
PUDUCHERRY,2008,Self-employed (Business activity),7,0,7
PUDUCHERRY,2008,Professional Activity,0,0,0
PUDUCHERRY,2008,Farming/Agriculture Activity,14,3,17
PUDUCHERRY,2008,Others (Please Specify),215,12,227
PUDUCHERRY,2008,Retired Person,1,0,1
PUDUCHERRY,2008,Others (Please Specify),2,0,2
PUDUCHERRY,2008,Total,334,173,507
PUDUCHERRY,2008,Total Salaried,18,11,29
PUDUCHERRY,2008,Total Self-employed,236,15,251
PUDUCHERRY,2009,House Wife,0,111,111
PUDUCHERRY,2009,Service (Government),11,1,12
PUDUCHERRY,2009,Service (Private),19,13,32
PUDUCHERRY,2009,Public Sector Undertaking,4,0,4
PUDUCHERRY,2009,Student,9,17,26
PUDUCHERRY,2009,Unemployed,76,37,113
PUDUCHERRY,2009,Self-employed (Business activity),9,0,9
PUDUCHERRY,2009,Professional Activity,49,5,54
PUDUCHERRY,2009,Farming/Agriculture Activity,146,8,154
PUDUCHERRY,2009,Others (Please Specify),2,0,2
PUDUCHERRY,2009,Retired Person,1,0,1
PUDUCHERRY,2009,Others (Please Specify),0,0,0
PUDUCHERRY,2009,Total,326,192,518
PUDUCHERRY,2009,Total Salaried,34,14,48
PUDUCHERRY,2009,Total Self-employed,206,13,219
PUDUCHERRY,2010,House Wife,0,95,95
PUDUCHERRY,2010,Service (Government),8,3,11
PUDUCHERRY,2010,Service (Private),21,17,38
PUDUCHERRY,2010,Public Sector Undertaking,4,2,6
PUDUCHERRY,2010,Student,6,12,18
PUDUCHERRY,2010,Unemployed,60,40,100
PUDUCHERRY,2010,Self-employed (Business activity),14,0,14
PUDUCHERRY,2010,Professional Activity,205,5,210
PUDUCHERRY,2010,Farming/Agriculture Activity,4,0,4
PUDUCHERRY,2010,Others (Please Specify),8,1,9
PUDUCHERRY,2010,Retired Person,3,0,3
PUDUCHERRY,2010,Others (Please Specify),0,0,0
PUDUCHERRY,2010,Total,333,175,508
PUDUCHERRY,2010,Total Salaried,33,22,55
PUDUCHERRY,2010,Total Self-employed,231,6,237
PUDUCHERRY,2011,House Wife,0,97,97
PUDUCHERRY,2011,Service (Government),10,1,11
PUDUCHERRY,2011,Service (Private),42,8,50
PUDUCHERRY,2011,Public Sector Undertaking,5,2,7
PUDUCHERRY,2011,Student,16,20,36
PUDUCHERRY,2011,Unemployed,72,32,104
PUDUCHERRY,2011,Self-employed (Business activity),46,1,47
PUDUCHERRY,2011,Professional Activity,170,0,170
PUDUCHERRY,2011,Farming/Agriculture Activity,0,0,0
PUDUCHERRY,2011,Others (Please Specify),35,0,35
PUDUCHERRY,2011,Retired Person,0,0,0
PUDUCHERRY,2011,Others (Please Specify),0,0,0
PUDUCHERRY,2011,Total,396,161,557
PUDUCHERRY,2011,Total Salaried,57,11,68
PUDUCHERRY,2011,Total Self-employed,251,1,252
PUDUCHERRY,2012,House Wife,0,103,103
PUDUCHERRY,2012,Service (Government),16,4,20
PUDUCHERRY,2012,Service (Private),11,9,20
PUDUCHERRY,2012,Public Sector Undertaking,0,2,2
PUDUCHERRY,2012,Student,23,22,45
PUDUCHERRY,2012,Unemployed,64,19,83
PUDUCHERRY,2012,Self-employed (Business activity),16,2,18
PUDUCHERRY,2012,Professional Activity,105,1,106
PUDUCHERRY,2012,Farming/Agriculture Activity,0,0,0
PUDUCHERRY,2012,Others (Please Specify),129,6,135
PUDUCHERRY,2012,Retired Person,6,0,6
PUDUCHERRY,2012,Others (Please Specify),2,1,3
PUDUCHERRY,2012,Total,372,169,541
PUDUCHERRY,2012,Total Salaried,27,15,42
PUDUCHERRY,2012,Total Self-employed,250,9,259
